City Name,CBG Code,Year,Median Household Income,Population Above Poverty,Population Below Poverty,Population With A Ratio Of Income To Poverty Level Below 0.5,Population With A Ratio Of Income To Poverty Level Between 0.5 And 0.99
Norfolk city,517100001001,2014,41467,974,111,88,23
Norfolk city,517100001001,2015,64432,873,118,95,23
Norfolk city,517100001001,2016,67692,875,111,87,24
Norfolk city,517100001001,2017,43616,785,106,85,21
Norfolk city,517100001001,2018,46696,805,197,87,110
Norfolk city,517100001001,2019,46397,625,146,55,91
Norfolk city,517100001001,2020,48214,703,109,29,80
Norfolk city,517100001001,2021,56198,772,103,35,68
Norfolk city,517100001002,2014,48143,1339,120,48,72
Norfolk city,517100001002,2015,49161,1135,220,77,143
Norfolk city,517100001002,2016,49421,905,205,81,124
Norfolk city,517100001002,2017,53750,863,177,70,107
Norfolk city,517100001002,2018,51875,838,231,130,101
Norfolk city,517100001002,2019,54541,1080,165,71,94
Norfolk city,517100001002,2020,58611,1092,150,74,76
Norfolk city,517100001002,2021,61563,1206,107,80,27
Norfolk city,517100002011,2014,32047,993,348,185,163
Norfolk city,517100002011,2015,34136,1222,405,165,240
Norfolk city,517100002011,2016,42284,1339,253,134,119
Norfolk city,517100002011,2017,41159,1303,205,72,133
Norfolk city,517100002011,2018,42587,1442,180,89,91
Norfolk city,517100002011,2019,44438,1497,184,80,104
Norfolk city,517100002011,2020,51208,1902,121,44,77
Norfolk city,517100002011,2021,48289,1281,113,53,60
Norfolk city,517100002012,2014,42500,1097,96,86,10
Norfolk city,517100002012,2015,41131,966,97,85,12
Norfolk city,517100002012,2016,41875,1127,90,81,9
Norfolk city,517100002012,2017,41651,1085,163,121,42
Norfolk city,517100002012,2018,48533,1163,170,124,46
Norfolk city,517100002012,2019,56042,990,126,71,55
Norfolk city,517100002012,2020,56900,1156,88,55,33
Norfolk city,517100002012,2021,55729,1059,107,61,46
Norfolk city,517100002021,2014,51369,586,141,56,85
Norfolk city,517100002021,2015,54167,609,161,63,98
Norfolk city,517100002021,2016,66071,701,125,74,51
Norfolk city,517100002021,2017,69135,665,88,22,66
Norfolk city,517100002021,2018,73281,761,100,20,80
Norfolk city,517100002021,2019,80313,765,61,0,61
Norfolk city,517100002021,2020,74180,739,43,0,43
Norfolk city,517100002021,2021,50278,632,60,0,60
Norfolk city,517100002022,2014,34044,862,274,55,219
Norfolk city,517100002022,2015,31674,745,366,82,284
Norfolk city,517100002022,2016,32500,774,377,69,308
Norfolk city,517100002022,2017,31932,739,452,94,358
Norfolk city,517100002022,2018,43125,675,191,82,109
Norfolk city,517100002022,2019,51471,742,93,68,25
Norfolk city,517100002022,2020,47031,721,93,66,27
Norfolk city,517100002022,2021,48900,733,115,67,48
Norfolk city,517100002023,2014,53611,857,258,1,257
Norfolk city,517100002023,2015,53611,963,260,26,234
Norfolk city,517100002023,2016,42031,742,281,35,246
Norfolk city,517100002023,2017,45962,765,282,35,247
Norfolk city,517100002023,2018,48953,975,38,19,19
Norfolk city,517100002023,2019,51375,865,40,20,20
Norfolk city,517100002023,2020,59609,1056,49,29,20
Norfolk city,517100002023,2021,66181,1240,59,38,21
Norfolk city,517100002024,2014,45991,635,222,108,114
Norfolk city,517100002024,2015,45795,703,139,73,66
Norfolk city,517100002024,2016,46875,702,134,124,10
Norfolk city,517100002024,2017,56538,837,88,88,0
Norfolk city,517100002024,2018,56326,973,122,122,0
Norfolk city,517100002024,2019,58657,1314,126,117,9
Norfolk city,517100002024,2020,57930,1404,132,120,12
Norfolk city,517100002024,2021,60712,1317,93,82,11
Norfolk city,517100003001,2014,55208,1059,58,38,20
Norfolk city,517100003001,2015,53750,978,89,46,43
Norfolk city,517100003001,2016,49076,1072,96,47,49
Norfolk city,517100003001,2017,59391,1102,84,28,56
Norfolk city,517100003001,2018,51731,1045,113,33,80
Norfolk city,517100003001,2019,60639,1135,83,28,55
Norfolk city,517100003001,2020,60726,949,202,157,45
Norfolk city,517100003001,2021,62863,771,184,138,46
Norfolk city,517100003002,2014,23333,431,332,119,213
Norfolk city,517100003002,2015,25216,402,302,138,164
Norfolk city,517100003002,2016,31310,450,215,126,89
Norfolk city,517100003002,2017,26856,554,139,111,28
Norfolk city,517100003002,2018,46100,521,156,47,109
Norfolk city,517100003002,2019,47995,764,173,50,123
Norfolk city,517100003002,2020,48045,685,139,17,122
Norfolk city,517100003002,2021,48074,728,202,22,180
Norfolk city,517100003003,2014,47560,1096,218,77,141
Norfolk city,517100003003,2015,58512,1243,204,63,141
Norfolk city,517100003003,2016,54667,1616,195,75,120
Norfolk city,517100003003,2017,50690,1264,108,58,50
Norfolk city,517100003003,2018,51410,1468,90,41,49
Norfolk city,517100003003,2019,50938,1086,58,37,21
Norfolk city,517100003003,2020,46591,972,66,38,28
Norfolk city,517100003003,2021,47543,753,61,22,39
Norfolk city,517100004001,2014,44159,1547,99,35,64
Norfolk city,517100004001,2015,47125,1307,106,34,72
Norfolk city,517100004001,2016,44985,1083,97,31,66
Norfolk city,517100004001,2017,60833,1071,109,34,75
Norfolk city,517100004001,2018,69236,1053,60,5,55
Norfolk city,517100004001,2019,71833,1041,78,4,74
Norfolk city,517100004001,2020,85313,969,70,7,63
Norfolk city,517100004001,2021,83839,1033,67,10,57
Norfolk city,517100004002,2014,46016,494,102,93,9
Norfolk city,517100004002,2015,51534,594,85,53,32
Norfolk city,517100004002,2016,51250,656,99,54,45
Norfolk city,517100004002,2017,53897,679,116,69,47
Norfolk city,517100004002,2018,65139,725,142,74,68
Norfolk city,517100004002,2019,65469,695,118,36,82
Norfolk city,517100004002,2020,50833,644,135,72,63
Norfolk city,517100004002,2021,52115,587,261,183,78
Norfolk city,517100004003,2014,41484,1169,211,123,88
Norfolk city,517100004003,2015,41397,1239,220,119,101
Norfolk city,517100004003,2016,42109,1258,264,139,125
Norfolk city,517100004003,2017,47969,1295,322,151,171
Norfolk city,517100004003,2018,43641,1279,262,96,166
Norfolk city,517100004003,2019,51042,1352,201,97,104
Norfolk city,517100004003,2020,53194,1366,161,100,61
Norfolk city,517100004003,2021,54426,1380,155,104,51
Norfolk city,517100005001,2014,41462,562,111,56,55
Norfolk city,517100005001,2015,50547,770,106,52,54
Norfolk city,517100005001,2016,49750,626,163,93,70
Norfolk city,517100005001,2017,50441,593,223,130,93
Norfolk city,517100005001,2018,44130,463,281,159,122
Norfolk city,517100005001,2019,53697,731,142,99,43
Norfolk city,517100005001,2020,35580,495,265,198,67
Norfolk city,517100005001,2021,46618,884,36,33,3
Norfolk city,517100005002,2014,45223,1086,379,66,313
Norfolk city,517100005002,2015,43350,957,397,81,316
Norfolk city,517100005002,2016,44954,1039,387,140,247
Norfolk city,517100005002,2017,56563,986,307,105,202
Norfolk city,517100005002,2018,63967,1036,115,66,49
Norfolk city,517100005002,2019,54688,1069,113,59,54
Norfolk city,517100005002,2020,83413,1523,118,62,56
Norfolk city,517100005002,2021,87604,1371,17,9,8
Norfolk city,517100005003,2014,45469,393,158,112,46
Norfolk city,517100005003,2015,46349,343,108,88,20
Norfolk city,517100005003,2016,53068,374,91,71,20
Norfolk city,517100005003,2017,54886,310,60,46,14
Norfolk city,517100005003,2018,54500,400,118,108,10
Norfolk city,517100005003,2019,66940,447,2,2,0
Norfolk city,517100005003,2020,65909,400,9,2,7
Norfolk city,517100005003,2021,54044,282,84,37,47
Norfolk city,517100005004,2014,57813,401,9,9,0
Norfolk city,517100005004,2015,32308,412,66,39,27
Norfolk city,517100005004,2016,31083,391,88,50,38
Norfolk city,517100005004,2017,34300,498,108,41,67
Norfolk city,517100005004,2018,34414,492,182,45,137
Norfolk city,517100005004,2019,33185,503,188,44,144
Norfolk city,517100005004,2020,41406,481,126,12,114
Norfolk city,517100005004,2021,41571,459,154,20,134
Norfolk city,517100006001,2014,47045,1397,126,95,31
Norfolk city,517100006001,2015,55273,1151,144,112,32
Norfolk city,517100006001,2016,45221,1116,142,127,15
Norfolk city,517100006001,2017,49189,904,64,64,0
Norfolk city,517100006001,2018,62250,764,36,15,21
Norfolk city,517100006001,2019,56813,820,86,20,66
Norfolk city,517100006001,2020,53778,751,167,69,98
Norfolk city,517100006001,2021,49025,894,262,161,101
Norfolk city,517100006002,2014,68750,643,84,75,9
Norfolk city,517100006002,2015,65938,738,91,83,8
Norfolk city,517100006002,2016,73450,923,110,62,48
Norfolk city,517100006002,2017,76607,1045,104,75,29
Norfolk city,517100006002,2018,84018,1109,97,59,38
Norfolk city,517100006002,2019,78750,1011,110,65,45
Norfolk city,517100006002,2020,61574,1032,132,75,57
Norfolk city,517100006002,2021,64553,906,90,64,26
Norfolk city,517100006003,2014,34675,1959,262,50,212
Norfolk city,517100006003,2015,40327,1936,372,96,276
Norfolk city,517100006003,2016,40872,1787,405,174,231
Norfolk city,517100006003,2017,42439,1932,454,174,280
Norfolk city,517100006003,2018,42193,2064,458,207,251
Norfolk city,517100006003,2019,42647,1966,632,316,316
Norfolk city,517100006003,2020,49028,941,190,65,125
Norfolk city,517100006003,2021,46667,762,233,83,150
Norfolk city,517100007001,2014,47393,932,116,17,99
Norfolk city,517100007001,2015,52679,777,101,15,86
Norfolk city,517100007001,2016,60068,864,65,14,51
Norfolk city,517100007001,2017,63264,929,88,0,88
Norfolk city,517100007001,2018,64886,864,142,21,121
Norfolk city,517100007001,2019,73371,878,116,22,94
Norfolk city,517100007001,2020,74688,775,111,29,82
Norfolk city,517100007001,2021,81500,845,155,49,106
Norfolk city,517100007002,2014,56595,1397,97,24,73
Norfolk city,517100007002,2015,63606,1598,85,22,63
Norfolk city,517100007002,2016,64459,1633,71,28,43
Norfolk city,517100007002,2017,76042,1872,6,6,0
Norfolk city,517100007002,2018,71833,2013,58,45,13
Norfolk city,517100007002,2019,78577,2037,67,53,14
Norfolk city,517100007002,2020,74559,1871,52,40,12
Norfolk city,517100007002,2021,73576,1734,47,31,16
Norfolk city,517100008001,2014,57454,1198,126,42,84
Norfolk city,517100008001,2015,57014,1021,141,46,95
Norfolk city,517100008001,2016,58500,945,153,51,102
Norfolk city,517100008001,2017,59962,927,83,62,21
Norfolk city,517100008001,2018,58859,976,114,65,49
Norfolk city,517100008001,2019,53906,918,107,35,72
Norfolk city,517100008001,2020,49741,930,105,11,94
Norfolk city,517100008001,2021,46125,953,143,4,139
Norfolk city,517100008002,2014,41080,744,229,22,207
Norfolk city,517100008002,2015,39594,781,206,21,185
Norfolk city,517100008002,2016,36429,737,239,20,219
Norfolk city,517100008002,2017,35926,731,147,26,121
Norfolk city,517100008002,2018,43125,741,111,30,81
Norfolk city,517100008002,2019,39000,676,201,131,70
Norfolk city,517100008002,2020,41111,678,209,145,64
Norfolk city,517100008002,2021,41916,691,129,128,1
Norfolk city,517100009011,2014,44159,3486,546,217,329
Norfolk city,517100009011,2015,43809,3348,616,252,364
Norfolk city,517100009011,2016,46351,3283,424,175,249
Norfolk city,517100009011,2017,43644,3105,392,125,267
Norfolk city,517100009011,2018,46178,2741,554,222,332
Norfolk city,517100009011,2019,47747,2525,830,317,513
Norfolk city,517100009011,2020,48500,640,70,3,67
Norfolk city,517100009011,2021,51691,658,64,4,60
Norfolk city,517100009021,2014,43185,1459,37,37,0
Norfolk city,517100009021,2015,45481,1429,42,35,7
Norfolk city,517100009021,2016,46000,1348,72,64,8
Norfolk city,517100009021,2017,38854,1314,75,57,18
Norfolk city,517100009021,2018,44886,1363,105,70,35
Norfolk city,517100009021,2019,43750,1109,228,66,162
Norfolk city,517100009021,2020,36919,1600,257,108,149
Norfolk city,517100009021,2021,45446,1635,242,77,165
Norfolk city,517100011001,2014,34526,1268,340,121,219
Norfolk city,517100011001,2015,33201,1103,581,330,251
Norfolk city,517100011001,2016,34957,1082,572,319,253
Norfolk city,517100011001,2017,35685,1098,395,279,116
Norfolk city,517100011001,2018,36685,1126,353,251,102
Norfolk city,517100011001,2019,41250,1126,337,288,49
Norfolk city,517100011001,2020,44332,1402,176,142,34
Norfolk city,517100011001,2021,48132,1132,144,101,43
Norfolk city,517100011002,2014,38426,954,258,252,6
Norfolk city,517100011002,2015,31927,924,370,368,2
Norfolk city,517100011002,2016,44516,934,183,175,8
Norfolk city,517100011002,2017,44375,791,223,190,33
Norfolk city,517100011002,2018,53295,648,193,160,33
Norfolk city,517100011002,2019,36892,631,203,163,40
Norfolk city,517100011002,2020,52250,515,71,41,30
Norfolk city,517100011002,2021,39221,531,150,78,72
Norfolk city,517100012001,2014,85972,1301,123,109,14
Norfolk city,517100012001,2015,84543,1548,66,46,20
Norfolk city,517100012001,2016,89663,1608,61,46,15
Norfolk city,517100012001,2017,118464,1616,39,34,5
Norfolk city,517100012001,2018,122371,1632,55,39,16
Norfolk city,517100012001,2019,132750,1429,63,46,17
Norfolk city,517100012001,2020,92401,1550,20,10,10
Norfolk city,517100012001,2021,97413,1444,18,9,9
Norfolk city,517100012002,2014,37246,2213,420,111,309
Norfolk city,517100012002,2015,41615,2177,304,104,200
Norfolk city,517100012002,2016,43116,2186,345,163,182
Norfolk city,517100012002,2017,41875,1936,377,154,223
Norfolk city,517100012002,2018,42390,1944,575,371,204
Norfolk city,517100012002,2019,60298,2141,524,329,195
Norfolk city,517100012002,2020,62702,1347,460,308,152
Norfolk city,517100012002,2021,46500,1178,471,243,228
Norfolk city,517100013001,2014,25813,441,53,31,22
Norfolk city,517100013001,2015,30949,455,55,34,21
Norfolk city,517100013001,2016,40646,413,46,22,24
Norfolk city,517100013001,2017,40706,440,72,34,38
Norfolk city,517100013001,2018,47734,593,21,9,12
Norfolk city,517100013001,2019,44008,627,22,11,11
Norfolk city,517100013001,2020,43459,598,20,10,10
Norfolk city,517100013001,2021,45799,506,29,19,10
Norfolk city,517100013002,2014,32365,1565,366,159,207
Norfolk city,517100013002,2015,35527,1617,339,165,174
Norfolk city,517100013002,2016,33690,1740,413,177,236
Norfolk city,517100013002,2017,38267,1588,463,116,347
Norfolk city,517100013002,2018,39199,1756,456,124,332
Norfolk city,517100013002,2019,41118,1544,669,101,568
Norfolk city,517100013002,2020,43715,1337,621,55,566
Norfolk city,517100013002,2021,46335,1167,501,31,470
Norfolk city,517100014001,2014,18261,904,269,74,195
Norfolk city,517100014001,2015,14470,675,307,77,230
Norfolk city,517100014001,2016,15045,674,289,55,234
Norfolk city,517100014001,2017,14753,554,300,93,207
Norfolk city,517100014001,2018,15718,537,359,91,268
Norfolk city,517100014001,2019,16204,708,354,88,266
Norfolk city,517100014001,2020,16483,684,316,95,221
Norfolk city,517100014001,2021,17554,625,295,83,212
Norfolk city,517100014002,2014,56724,667,74,74,0
Norfolk city,517100014002,2015,55991,571,179,62,117
Norfolk city,517100014002,2016,55714,632,199,141,58
Norfolk city,517100014002,2017,58550,781,257,128,129
Norfolk city,517100014002,2018,50875,881,212,107,105
Norfolk city,517100014002,2019,39657,742,220,56,164
Norfolk city,517100014002,2020,40083,854,149,105,44
Norfolk city,517100014002,2021,36627,760,124,78,46
Norfolk city,517100014003,2014,70565,745,59,0,59
Norfolk city,517100014003,2015,71797,908,43,0,43
Norfolk city,517100014003,2016,72014,764,7,0,7
Norfolk city,517100014003,2017,86776,663,18,0,18
Norfolk city,517100014003,2018,102750,629,20,0,20
Norfolk city,517100014003,2019,118750,681,7,0,7
Norfolk city,517100014003,2020,119773,489,73,0,73
Norfolk city,517100014003,2021,113889,532,63,0,63
Norfolk city,517100015001,2014,66411,522,4,4,0
Norfolk city,517100015001,2015,63661,541,21,15,6
Norfolk city,517100015001,2016,55962,588,34,14,20
Norfolk city,517100015001,2017,66042,562,33,12,21
Norfolk city,517100015001,2018,71964,512,25,4,21
Norfolk city,517100015001,2019,79375,577,28,4,24
Norfolk city,517100015001,2020,58500,440,32,14,18
Norfolk city,517100015001,2021,76071,306,30,15,15
Norfolk city,517100015002,2014,50740,1330,233,136,97
Norfolk city,517100015002,2015,52660,1192,247,139,108
Norfolk city,517100015002,2016,57702,1140,302,95,207
Norfolk city,517100015002,2017,62695,1087,213,80,133
Norfolk city,517100015002,2018,65761,1164,192,67,125
Norfolk city,517100015002,2019,66724,1368,164,48,116
Norfolk city,517100015002,2020,70185,1658,166,63,103
Norfolk city,517100015002,2021,76134,1767,87,63,24
Norfolk city,517100016001,2014,22143,635,183,73,110
Norfolk city,517100016001,2015,29375,610,184,65,119
Norfolk city,517100016001,2016,22946,532,179,47,132
Norfolk city,517100016001,2017,28571,673,169,55,114
Norfolk city,517100016001,2018,27250,614,247,149,98
Norfolk city,517100016001,2019,32500,697,209,108,101
Norfolk city,517100016001,2020,26921,797,262,214,48
Norfolk city,517100016001,2021,31058,689,274,238,36
Norfolk city,517100016002,2014,50686,884,224,31,193
Norfolk city,517100016002,2015,46667,851,435,159,276
Norfolk city,517100016002,2016,43750,910,294,164,130
Norfolk city,517100016002,2017,46111,869,257,144,113
Norfolk city,517100016002,2018,54760,901,187,176,11
Norfolk city,517100016002,2019,54722,894,154,142,12
Norfolk city,517100016002,2020,51731,768,76,22,54
Norfolk city,517100016002,2021,67632,1000,70,19,51
Norfolk city,517100017001,2014,40864,916,195,90,105
Norfolk city,517100017001,2015,35625,869,201,72,129
Norfolk city,517100017001,2016,33628,867,167,70,97
Norfolk city,517100017001,2017,37384,908,162,44,118
Norfolk city,517100017001,2018,44200,1048,164,40,124
Norfolk city,517100017001,2019,50278,925,93,14,79
Norfolk city,517100017001,2020,45595,1008,125,14,111
Norfolk city,517100017001,2021,54048,1086,137,16,121
Norfolk city,517100017002,2014,35406,1128,214,67,147
Norfolk city,517100017002,2015,40945,1224,151,7,144
Norfolk city,517100017002,2016,43438,1103,116,14,102
Norfolk city,517100017002,2017,50139,902,95,17,78
Norfolk city,517100017002,2018,50729,705,133,17,116
Norfolk city,517100017002,2019,52898,930,100,18,82
Norfolk city,517100017002,2020,66250,757,114,19,95
Norfolk city,517100017002,2021,67250,769,128,30,98
Norfolk city,517100020001,2014,67500,1193,60,8,52
Norfolk city,517100020001,2015,63864,1201,36,10,26
Norfolk city,517100020001,2016,67128,1273,65,25,40
Norfolk city,517100020001,2017,66510,1403,66,27,39
Norfolk city,517100020001,2018,64911,1346,81,33,48
Norfolk city,517100020001,2019,72321,1339,113,31,82
Norfolk city,517100020001,2020,67045,1228,104,39,65
Norfolk city,517100020001,2021,66776,1204,71,17,54
Norfolk city,517100021001,2014,91944,1288,173,26,147
Norfolk city,517100021001,2015,76591,1256,215,30,185
Norfolk city,517100021001,2016,81667,1251,254,60,194
Norfolk city,517100021001,2017,82031,1203,331,73,258
Norfolk city,517100021001,2018,83375,1233,265,68,197
Norfolk city,517100021001,2019,87885,1209,217,61,156
Norfolk city,517100021001,2020,98160,1226,112,22,90
Norfolk city,517100021001,2021,103146,1289,86,12,74
Norfolk city,517100022001,2014,132813,1084,19,10,9
Norfolk city,517100022001,2015,127778,1073,23,9,14
Norfolk city,517100022001,2016,131167,1071,23,9,14
Norfolk city,517100022001,2017,121250,1050,19,9,10
Norfolk city,517100022001,2018,122188,1039,23,18,5
Norfolk city,517100022001,2019,120385,973,21,8,13
Norfolk city,517100022001,2020,96250,912,26,18,8
Norfolk city,517100022001,2021,107014,1042,29,20,9
Norfolk city,517100022002,2014,76250,739,52,44,8
Norfolk city,517100022002,2015,80500,771,29,24,5
Norfolk city,517100022002,2016,94107,651,13,13,0
Norfolk city,517100022002,2017,87045,614,13,0,13
Norfolk city,517100022002,2018,103942,658,14,0,14
Norfolk city,517100022002,2019,108750,723,23,7,16
Norfolk city,517100022002,2020,108603,671,19,5,14
Norfolk city,517100022002,2021,152750,723,19,7,12
Norfolk city,517100023001,2014,148382,1109,34,34,0
Norfolk city,517100023001,2015,121683,1182,36,36,0
Norfolk city,517100023001,2016,122069,1077,30,30,0
Norfolk city,517100023001,2017,135313,1045,23,18,5
Norfolk city,517100023001,2018,143542,1086,36,20,16
Norfolk city,517100023001,2019,130156,1105,46,36,10
Norfolk city,517100023001,2020,143306,1158,82,61,21
Norfolk city,517100023001,2021,148146,996,134,66,68
Norfolk city,517100023002,2014,45980,812,238,192,46
Norfolk city,517100023002,2015,54706,757,186,160,26
Norfolk city,517100023002,2016,53875,769,173,112,61
Norfolk city,517100023002,2017,44808,768,190,118,72
Norfolk city,517100023002,2018,61111,819,180,117,63
Norfolk city,517100023002,2019,46591,757,182,116,66
Norfolk city,517100023002,2020,62917,767,165,93,72
Norfolk city,517100023002,2021,54688,822,152,113,39
Norfolk city,517100024001,2014,114808,1148,94,80,14
Norfolk city,517100024001,2015,132031,1206,104,69,35
Norfolk city,517100024001,2016,127688,1278,72,58,14
Norfolk city,517100024001,2017,128056,1396,81,64,17
Norfolk city,517100024001,2018,150707,1380,15,0,15
Norfolk city,517100024001,2019,152941,1308,16,0,16
Norfolk city,517100024001,2020,131324,1387,0,0,0
Norfolk city,517100024001,2021,148512,1321,0,0,0
Norfolk city,517100024002,2014,106563,1115,26,19,7
Norfolk city,517100024002,2015,101406,989,34,27,7
Norfolk city,517100024002,2016,88654,903,19,19,0
Norfolk city,517100024002,2017,90625,855,20,20,0
Norfolk city,517100024002,2018,105625,760,0,0,0
Norfolk city,517100024002,2019,109830,806,0,0,0
Norfolk city,517100024002,2020,143958,1107,0,0,0
Norfolk city,517100024002,2021,150250,1125,0,0,0
Norfolk city,517100024003,2014,66042,910,203,147,56
Norfolk city,517100024003,2015,68654,994,551,417,134
Norfolk city,517100024003,2016,67634,1018,562,404,158
Norfolk city,517100024003,2017,71346,893,625,473,152
Norfolk city,517100024003,2018,94688,1000,511,365,146
Norfolk city,517100024003,2019,80588,894,649,457,192
Norfolk city,517100024003,2020,93309,771,348,246,102
Norfolk city,517100024003,2021,97500,775,285,209,76
Norfolk city,517100025001,2014,26250,468,711,499,212
Norfolk city,517100025001,2015,23173,420,648,418,230
Norfolk city,517100025001,2016,24342,484,620,378,242
Norfolk city,517100025001,2017,28000,575,616,420,196
Norfolk city,517100025001,2018,28681,655,675,468,207
Norfolk city,517100025001,2019,30139,706,494,345,149
Norfolk city,517100025001,2020,33929,643,424,276,148
Norfolk city,517100025001,2021,13900,524,432,310,122
Norfolk city,517100025002,2014,26339,615,522,247,275
Norfolk city,517100025002,2015,27353,744,512,298,214
Norfolk city,517100025002,2016,24866,765,541,365,176
Norfolk city,517100025002,2017,24890,690,784,482,302
Norfolk city,517100025002,2018,25343,717,686,462,224
Norfolk city,517100025002,2019,40221,647,575,398,177
Norfolk city,517100025002,2020,39013,576,420,279,141
Norfolk city,517100025002,2021,49545,671,453,226,227
Norfolk city,517100026001,2014,31779,795,702,550,152
Norfolk city,517100026001,2015,31250,805,654,468,186
Norfolk city,517100026001,2016,23500,619,595,431,164
Norfolk city,517100026001,2017,32841,650,536,381,155
Norfolk city,517100026001,2018,32734,671,482,302,180
Norfolk city,517100026001,2019,37557,932,453,277,176
Norfolk city,517100026001,2020,15538,303,950,699,251
Norfolk city,517100026001,2021,19485,430,833,545,288
Norfolk city,517100026002,2014,17760,464,1036,897,139
Norfolk city,517100026002,2015,12477,432,1214,999,215
Norfolk city,517100026002,2016,10786,393,1373,1119,254
Norfolk city,517100026002,2017,12571,342,1278,988,290
Norfolk city,517100026002,2018,12750,346,1094,837,257
Norfolk city,517100026002,2019,12589,277,915,616,299
Norfolk city,517100026002,2020,23571,314,173,131,42
Norfolk city,517100026002,2021,27917,316,169,90,79
Norfolk city,517100027001,2014,43929,250,63,31,32
Norfolk city,517100027001,2015,45521,363,92,40,52
Norfolk city,517100027001,2016,47292,308,66,22,44
Norfolk city,517100027001,2017,59438,589,121,44,77
Norfolk city,517100027001,2018,61607,537,159,35,124
Norfolk city,517100027001,2019,60694,561,121,32,89
Norfolk city,517100027001,2020,62716,450,70,38,32
Norfolk city,517100027001,2021,62366,552,101,80,21
Norfolk city,517100027002,2014,23875,850,704,224,480
Norfolk city,517100027002,2015,19338,803,593,201,392
Norfolk city,517100027002,2016,29615,1042,496,192,304
Norfolk city,517100027002,2017,28490,1059,301,88,213
Norfolk city,517100027002,2018,24432,870,251,91,160
Norfolk city,517100027002,2019,24013,654,341,184,157
Norfolk city,517100027002,2020,36477,764,258,133,125
Norfolk city,517100027002,2021,28583,398,226,131,95
Norfolk city,517100027003,2014,30833,938,215,173,42
Norfolk city,517100027003,2015,28922,896,229,199,30
Norfolk city,517100027003,2016,32314,906,117,117,0
Norfolk city,517100027003,2017,31830,919,349,186,163
Norfolk city,517100027003,2018,31020,890,352,149,203
Norfolk city,517100027003,2019,31949,905,406,193,213
Norfolk city,517100027003,2020,36313,1030,341,138,203
Norfolk city,517100027003,2021,35259,985,407,158,249
Norfolk city,517100028001,2014,102902,536,42,15,27
Norfolk city,517100028001,2015,101250,499,53,28,25
Norfolk city,517100028001,2016,71696,673,96,70,26
Norfolk city,517100028001,2017,80781,745,99,71,28
Norfolk city,517100028001,2018,80096,643,90,69,21
Norfolk city,517100028001,2019,94583,634,49,49,0
Norfolk city,517100028001,2020,77261,634,35,35,0
Norfolk city,517100028001,2021,78834,619,20,20,0
Norfolk city,517100028002,2014,66280,845,141,129,12
Norfolk city,517100028002,2015,64900,745,111,98,13
Norfolk city,517100028002,2016,66840,850,161,144,17
Norfolk city,517100028002,2017,63021,576,180,159,21
Norfolk city,517100028002,2018,61979,534,157,137,20
Norfolk city,517100028002,2019,62604,535,147,124,23
Norfolk city,517100028002,2020,38214,286,111,78,33
Norfolk city,517100028002,2021,40972,248,72,35,37
Norfolk city,517100028003,2014,81944,1009,23,0,23
Norfolk city,517100028003,2015,81538,975,53,17,36
Norfolk city,517100028003,2016,81700,996,47,15,32
Norfolk city,517100028003,2017,82614,1009,84,15,69
Norfolk city,517100028003,2018,77292,1041,84,15,69
Norfolk city,517100028003,2019,73077,1038,73,16,57
Norfolk city,517100028003,2020,68125,1121,34,0,34
Norfolk city,517100028003,2021,71574,987,39,0,39
Norfolk city,517100028004,2014,75923,1421,218,105,113
Norfolk city,517100028004,2015,76014,1293,178,72,106
Norfolk city,517100028004,2016,71333,1014,172,81,91
Norfolk city,517100028004,2017,74219,1114,118,80,38
Norfolk city,517100028004,2018,67070,1213,132,95,37
Norfolk city,517100028004,2019,76597,1192,42,37,5
Norfolk city,517100028004,2020,81060,1703,98,58,40
Norfolk city,517100028004,2021,85583,1746,66,29,37
Norfolk city,517100029001,2014,27449,892,118,70,48
Norfolk city,517100029001,2015,27350,849,117,64,53
Norfolk city,517100029001,2016,24805,768,255,138,117
Norfolk city,517100029001,2017,19853,482,254,138,116
Norfolk city,517100029001,2018,22000,656,285,178,107
Norfolk city,517100029001,2019,22007,692,277,187,90
Norfolk city,517100029001,2020,22091,631,234,158,76
Norfolk city,517100029001,2021,47688,531,163,119,44
Norfolk city,517100029002,2014,22147,686,275,182,93
Norfolk city,517100029002,2016,0,667,258,153,105
Norfolk city,517100029002,2017,45156,897,393,254,139
Norfolk city,517100029002,2018,47828,771,242,154,88
Norfolk city,517100029002,2019,50792,1026,130,85,45
Norfolk city,517100029002,2020,46646,788,122,85,37
Norfolk city,517100029002,2021,48670,894,145,98,47
Norfolk city,517100029003,2014,49000,513,73,19,54
Norfolk city,517100029003,2015,44125,648,73,21,52
Norfolk city,517100029003,2016,42377,511,205,154,51
Norfolk city,517100029003,2017,0,407,161,113,48
Norfolk city,517100029003,2018,0,402,205,135,70
Norfolk city,517100029003,2019,43298,350,165,130,35
Norfolk city,517100029003,2020,38750,280,128,90,38
Norfolk city,517100029004,2014,39508,719,448,100,348
Norfolk city,517100029004,2015,38220,772,247,153,94
Norfolk city,517100029004,2016,27471,701,208,178,30
Norfolk city,517100029004,2017,26771,659,328,203,125
Norfolk city,517100029004,2018,19375,678,395,246,149
Norfolk city,517100029004,2019,0,670,548,375,173
Norfolk city,517100029004,2020,0,863,471,269,202
Norfolk city,517100030001,2014,43036,909,220,142,78
Norfolk city,517100030001,2015,41435,839,379,264,115
Norfolk city,517100030001,2016,43304,868,318,230,88
Norfolk city,517100030001,2017,55455,905,262,172,90
Norfolk city,517100030001,2018,56964,884,236,151,85
Norfolk city,517100030001,2019,61167,931,199,116,83
Norfolk city,517100030001,2020,61582,1224,130,41,89
Norfolk city,517100030001,2021,65774,1112,98,30,68
Norfolk city,517100030002,2014,90188,739,86,51,35
Norfolk city,517100030002,2015,90347,627,63,17,46
Norfolk city,517100030002,2016,91905,698,84,33,51
Norfolk city,517100030002,2017,74250,567,102,27,75
Norfolk city,517100030002,2018,78500,554,88,14,74
Norfolk city,517100030002,2019,85912,613,23,11,12
Norfolk city,517100030002,2020,85117,530,20,11,9
Norfolk city,517100030002,2021,91210,550,32,20,12
Norfolk city,517100031001,2014,34750,811,158,9,149
Norfolk city,517100031001,2015,37167,836,120,8,112
Norfolk city,517100031001,2016,34525,918,77,37,40
Norfolk city,517100031001,2017,40430,927,46,32,14
Norfolk city,517100031001,2018,47736,951,54,43,11
Norfolk city,517100031001,2019,48417,1050,52,41,11
Norfolk city,517100031001,2020,44901,874,75,68,7
Norfolk city,517100031001,2021,41447,752,234,174,60
Norfolk city,517100031002,2014,30893,525,160,151,9
Norfolk city,517100031002,2015,26653,443,246,162,84
Norfolk city,517100031002,2016,25865,435,241,152,89
Norfolk city,517100031002,2017,30664,474,224,110,114
Norfolk city,517100031002,2018,24583,296,244,115,129
Norfolk city,517100031002,2019,29766,298,191,15,176
Norfolk city,517100031002,2020,34300,337,83,16,67
Norfolk city,517100031003,2014,37500,978,378,85,293
Norfolk city,517100031003,2015,38289,856,250,87,163
Norfolk city,517100031003,2016,36735,737,328,169,159
Norfolk city,517100031003,2017,37984,837,471,168,303
Norfolk city,517100031003,2018,42944,989,384,143,241
Norfolk city,517100031003,2019,44500,965,406,101,305
Norfolk city,517100031003,2020,46589,1080,333,76,257
Norfolk city,517100031003,2021,49238,890,344,24,320
Norfolk city,517100032001,2014,32917,544,249,52,197
Norfolk city,517100032001,2015,36964,704,153,42,111
Norfolk city,517100032001,2016,49375,862,134,46,88
Norfolk city,517100032001,2017,49063,760,150,41,109
Norfolk city,517100032001,2018,48182,748,130,31,99
Norfolk city,517100032001,2019,39783,781,129,67,62
Norfolk city,517100032001,2020,46688,800,125,80,45
Norfolk city,517100032001,2021,49550,684,89,76,13
Norfolk city,517100032002,2014,40417,599,50,50,0
Norfolk city,517100032002,2015,49375,633,95,81,14
Norfolk city,517100032002,2016,48250,700,125,104,21
Norfolk city,517100032002,2017,54917,789,181,142,39
Norfolk city,517100032002,2018,57279,802,188,141,47
Norfolk city,517100032002,2019,58667,808,136,84,52
Norfolk city,517100032002,2020,62083,710,30,15,15
Norfolk city,517100032002,2021,69479,810,29,11,18
Norfolk city,517100032003,2014,36743,1024,249,172,77
Norfolk city,517100032003,2015,45714,1042,306,221,85
Norfolk city,517100032003,2016,46875,1016,309,199,110
Norfolk city,517100032003,2017,47656,1107,352,183,169
Norfolk city,517100032003,2018,52167,1069,347,148,199
Norfolk city,517100032003,2019,52361,1103,311,121,190
Norfolk city,517100032003,2020,54167,1084,295,85,210
Norfolk city,517100032003,2021,53542,930,257,95,162
Norfolk city,517100033001,2014,46042,1131,148,31,117
Norfolk city,517100033001,2015,41500,1122,208,28,180
Norfolk city,517100033001,2016,43355,1112,286,53,233
Norfolk city,517100033001,2017,43152,1047,268,28,240
Norfolk city,517100033001,2018,37446,1009,288,46,242
Norfolk city,517100033001,2019,37649,916,368,141,227
Norfolk city,517100033001,2020,47083,815,504,275,229
Norfolk city,517100033001,2021,53239,773,378,245,133
Norfolk city,517100033002,2014,52857,1254,143,55,88
Norfolk city,517100033002,2015,43542,1169,216,71,145
Norfolk city,517100033002,2016,50481,880,258,184,74
Norfolk city,517100033002,2017,54625,872,392,344,48
Norfolk city,517100033002,2018,54000,918,465,392,73
Norfolk city,517100033002,2019,65250,899,507,416,91
Norfolk city,517100033002,2020,73869,995,402,361,41
Norfolk city,517100033002,2021,79808,1100,337,297,40
Norfolk city,517100034001,2014,27663,617,457,140,317
Norfolk city,517100034001,2015,27986,655,359,76,283
Norfolk city,517100034001,2016,32596,837,303,36,267
Norfolk city,517100034001,2017,33750,889,314,33,281
Norfolk city,517100034001,2018,36731,895,306,27,279
Norfolk city,517100034001,2019,36176,984,163,20,143
Norfolk city,517100034001,2020,40227,757,241,16,225
Norfolk city,517100034001,2021,42500,681,259,17,242
Norfolk city,517100034002,2014,35742,834,534,227,307
Norfolk city,517100034002,2015,35469,924,460,270,190
Norfolk city,517100034002,2016,36926,915,454,230,224
Norfolk city,517100034002,2017,37460,980,326,145,181
Norfolk city,517100034002,2018,37500,936,346,165,181
Norfolk city,517100034002,2019,37750,853,229,165,64
Norfolk city,517100034002,2020,36875,756,153,102,51
Norfolk city,517100034002,2021,38421,620,135,120,15
Norfolk city,517100035011,2014,9640,221,349,144,205
Norfolk city,517100035011,2015,10081,171,349,137,212
Norfolk city,517100035011,2016,10734,191,276,144,132
Norfolk city,517100035011,2017,11429,260,264,142,122
Norfolk city,517100035011,2018,12292,264,358,154,204
Norfolk city,517100035011,2019,13125,169,403,161,242
Norfolk city,517100035011,2020,16764,240,556,148,408
Norfolk city,517100035011,2021,16456,334,864,439,425
Norfolk city,517100035012,2014,54712,532,277,131,146
Norfolk city,517100035012,2016,0,406,314,209,105
Norfolk city,517100035012,2017,19063,341,240,146,94
Norfolk city,517100035012,2018,19671,334,207,168,39
Norfolk city,517100035012,2019,18203,336,152,106,46
Norfolk city,517100035012,2020,17470,430,321,290,31
Norfolk city,517100035013,2014,35542,513,129,58,71
Norfolk city,517100035013,2015,37222,527,190,87,103
Norfolk city,517100035013,2016,48233,579,116,15,101
Norfolk city,517100035013,2017,49516,529,133,11,122
Norfolk city,517100035013,2018,74375,487,158,23,135
Norfolk city,517100035013,2019,55563,536,159,22,137
Norfolk city,517100035013,2020,82344,925,70,8,62
Norfolk city,517100035013,2021,55694,752,74,21,53
Norfolk city,517100035014,2014,36080,764,237,82,155
Norfolk city,517100035014,2015,40208,766,215,18,197
Norfolk city,517100035014,2016,29850,692,236,77,159
Norfolk city,517100035014,2017,36838,739,186,78,108
Norfolk city,517100035014,2018,38824,829,226,85,141
Norfolk city,517100035014,2019,26875,651,332,168,164
Norfolk city,517100035014,2020,20833,344,296,174,122
Norfolk city,517100035014,2021,33939,321,135,28,107
Norfolk city,517100036001,2014,53550,1249,115,102,13
Norfolk city,517100036001,2015,61979,1421,119,106,13
Norfolk city,517100036001,2016,69583,1513,99,89,10
Norfolk city,517100036001,2017,67159,1542,85,70,15
Norfolk city,517100036001,2018,72167,1604,103,64,39
Norfolk city,517100036001,2019,75104,1781,105,62,43
Norfolk city,517100036001,2020,67206,1747,114,64,50
Norfolk city,517100036001,2021,65750,1806,170,120,50
Norfolk city,517100037001,2014,73856,824,87,57,30
Norfolk city,517100037001,2015,74420,816,117,91,26
Norfolk city,517100037001,2016,90227,571,104,81,23
Norfolk city,517100037001,2017,93813,634,400,313,87
Norfolk city,517100037001,2018,89750,636,324,271,53
Norfolk city,517100037001,2019,86563,557,339,280,59
Norfolk city,517100037001,2020,91964,466,229,185,44
Norfolk city,517100037001,2021,82969,501,211,172,39
Norfolk city,517100037002,2014,32417,878,329,269,60
Norfolk city,517100037002,2015,31466,863,351,265,86
Norfolk city,517100037002,2016,40735,937,326,231,95
Norfolk city,517100037002,2017,44821,1016,231,159,72
Norfolk city,517100037002,2018,41495,1069,221,163,58
Norfolk city,517100037002,2019,51800,1269,212,124,88
Norfolk city,517100037002,2020,54702,1281,141,68,73
Norfolk city,517100037002,2021,48409,1264,184,78,106
Norfolk city,517100038001,2014,65417,139,44,0,44
Norfolk city,517100038001,2015,58295,128,46,0,46
Norfolk city,517100038001,2016,60125,78,25,0,25
Norfolk city,517100038001,2017,0,101,65,29,36
Norfolk city,517100038001,2018,0,44,43,20,23
Norfolk city,517100038001,2019,0,145,35,27,8
Norfolk city,517100038001,2020,0,124,42,23,19
Norfolk city,517100038002,2014,62778,994,143,120,23
Norfolk city,517100038002,2015,73456,1201,160,130,30
Norfolk city,517100038002,2016,80242,1231,91,58,33
Norfolk city,517100038002,2017,81711,1219,59,43,16
Norfolk city,517100038002,2018,90750,1198,48,18,30
Norfolk city,517100038002,2019,90238,1262,86,36,50
Norfolk city,517100038002,2020,94595,1241,72,22,50
Norfolk city,517100038002,2021,113813,1287,146,98,48
Norfolk city,517100038003,2014,57813,1141,109,29,80
Norfolk city,517100038003,2015,65707,1239,59,0,59
Norfolk city,517100038003,2016,77756,1234,77,36,41
Norfolk city,517100038003,2017,77569,1210,79,38,41
Norfolk city,517100038003,2018,82321,1154,64,29,35
Norfolk city,517100038003,2019,83393,1009,78,30,48
Norfolk city,517100038003,2020,72361,823,88,26,62
Norfolk city,517100038003,2021,89250,799,62,14,48
Norfolk city,517100040011,2014,100865,1187,46,41,5
Norfolk city,517100040011,2015,94048,1156,49,45,4
Norfolk city,517100040011,2016,93816,1156,45,34,11
Norfolk city,517100040011,2017,94519,1232,37,26,11
Norfolk city,517100040011,2018,96369,1140,56,50,6
Norfolk city,517100040011,2019,87313,1218,52,43,9
Norfolk city,517100040011,2020,105000,1238,59,50,9
Norfolk city,517100040011,2021,114837,1326,29,24,5
Norfolk city,517100040021,2014,61164,1319,305,141,164
Norfolk city,517100040021,2015,43816,1209,298,173,125
Norfolk city,517100040021,2016,63981,1197,244,162,82
Norfolk city,517100040021,2017,55000,1087,233,167,66
Norfolk city,517100040021,2018,53523,1048,97,70,27
Norfolk city,517100040021,2019,49889,939,98,66,32
Norfolk city,517100040021,2020,45709,1079,198,170,28
Norfolk city,517100040021,2021,53147,1129,129,94,35
Norfolk city,517100040022,2014,75938,290,9,9,0
Norfolk city,517100040022,2015,69375,236,9,9,0
Norfolk city,517100040022,2016,104375,263,9,9,0
Norfolk city,517100040022,2017,111122,340,24,0,24
Norfolk city,517100040022,2018,0,356,40,15,25
Norfolk city,517100040022,2019,95313,351,39,16,23
Norfolk city,517100040022,2020,52917,348,95,95,0
Norfolk city,517100040022,2021,56071,322,117,117,0
Norfolk city,517100040023,2014,45909,727,221,194,27
Norfolk city,517100040023,2015,47882,823,158,138,20
Norfolk city,517100040023,2016,43352,908,186,163,23
Norfolk city,517100040023,2017,50069,1000,188,182,6
Norfolk city,517100040023,2018,55000,910,150,150,0
Norfolk city,517100040023,2019,71667,962,149,139,10
Norfolk city,517100040023,2020,70969,1361,184,156,28
Norfolk city,517100040023,2021,72891,1231,184,151,33
Norfolk city,517100040024,2014,48935,397,114,79,35
Norfolk city,517100040024,2015,51250,417,120,71,49
Norfolk city,517100040024,2016,31806,362,127,76,51
Norfolk city,517100040024,2017,36083,351,105,57,48
Norfolk city,517100040024,2018,37292,388,131,108,23
Norfolk city,517100040024,2019,33889,319,142,127,15
Norfolk city,517100041001,2014,11691,518,1365,714,651
Norfolk city,517100041001,2015,10187,386,1577,997,580
Norfolk city,517100041001,2016,11145,470,1590,929,661
Norfolk city,517100041001,2017,12321,502,1655,848,807
Norfolk city,517100041001,2018,11197,366,1763,921,842
Norfolk city,517100041001,2019,11852,440,1771,885,886
Norfolk city,517100041001,2020,11581,517,1537,715,822
Norfolk city,517100041001,2021,11844,568,1363,739,624
Norfolk city,517100042001,2014,15313,284,397,101,296
Norfolk city,517100042001,2015,14924,270,440,105,335
Norfolk city,517100042001,2016,14914,265,292,66,226
Norfolk city,517100042001,2017,12639,200,274,64,210
Norfolk city,517100042001,2018,12202,224,271,131,140
Norfolk city,517100042001,2019,13859,304,418,162,256
Norfolk city,517100042001,2020,0,199,68,10,58
Norfolk city,517100042002,2014,15263,229,652,248,404
Norfolk city,517100042002,2015,14167,193,515,224,291
Norfolk city,517100042002,2016,15972,210,674,294,380
Norfolk city,517100042002,2017,13672,232,827,395,432
Norfolk city,517100042002,2018,13227,286,773,491,282
Norfolk city,517100042002,2019,13879,339,714,509,205
Norfolk city,517100042002,2020,13534,292,689,463,226
Norfolk city,517100042002,2021,13060,263,773,581,192
Norfolk city,517100043001,2014,30545,355,267,267,0
Norfolk city,517100043001,2015,31763,457,114,107,7
Norfolk city,517100043001,2016,33036,529,14,8,6
Norfolk city,517100043001,2017,36691,532,9,0,9
Norfolk city,517100043001,2018,37007,673,89,7,82
Norfolk city,517100043001,2019,40750,692,77,9,68
Norfolk city,517100043001,2020,43517,842,659,9,650
Norfolk city,517100043001,2021,34894,894,651,14,637
Norfolk city,517100043002,2014,14706,573,873,175,698
Norfolk city,517100043002,2015,16378,637,780,198,582
Norfolk city,517100043002,2016,16115,627,1015,224,791
Norfolk city,517100043002,2017,18085,1016,700,166,534
Norfolk city,517100043002,2018,20967,1130,536,165,371
Norfolk city,517100043002,2019,21446,1406,401,150,251
Norfolk city,517100043002,2020,21502,1085,345,134,211
Norfolk city,517100043002,2021,23701,1031,222,37,185
Norfolk city,517100043003,2014,14028,385,179,43,136
Norfolk city,517100043003,2015,9587,238,180,53,127
Norfolk city,517100043003,2016,9282,260,136,27,109
Norfolk city,517100043003,2017,9242,224,139,26,113
Norfolk city,517100043003,2018,9136,97,144,25,119
Norfolk city,517100043003,2019,8722,119,202,97,105
Norfolk city,517100043003,2020,8917,142,196,114,82
Norfolk city,517100043003,2021,13621,151,303,93,210
Norfolk city,517100043004,2014,11536,179,226,125,101
Norfolk city,517100043004,2015,15179,264,139,69,70
Norfolk city,517100043004,2016,17174,164,79,32,47
Norfolk city,517100043004,2017,16971,226,76,24,52
Norfolk city,517100043004,2018,0,241,72,19,53
Norfolk city,517100043004,2019,0,209,71,11,60
Norfolk city,517100043004,2020,113264,219,14,14,0
Norfolk city,517100044001,2014,35417,277,44,0,44
Norfolk city,517100044001,2015,34643,315,41,0,41
Norfolk city,517100044001,2016,40000,292,19,0,19
Norfolk city,517100044001,2017,36696,353,33,0,33
Norfolk city,517100044001,2018,37411,277,79,10,69
Norfolk city,517100044001,2019,36000,308,177,14,163
Norfolk city,517100044001,2020,0,402,234,26,208
Norfolk city,517100044002,2014,54063,831,135,5,130
Norfolk city,517100044002,2015,64000,758,141,22,119
Norfolk city,517100044002,2016,65208,895,109,27,82
Norfolk city,517100044002,2017,56758,726,98,42,56
Norfolk city,517100044002,2018,63264,857,96,41,55
Norfolk city,517100044002,2019,64500,975,54,39,15
Norfolk city,517100044002,2020,63696,931,36,21,15
Norfolk city,517100044002,2021,69960,837,42,22,20
Norfolk city,517100044003,2014,30372,181,51,47,4
Norfolk city,517100044003,2015,29500,178,64,49,15
Norfolk city,517100044003,2016,30116,182,62,52,10
Norfolk city,517100044003,2017,30219,188,61,56,5
Norfolk city,517100044003,2018,21467,154,66,59,7
Norfolk city,517100044003,2019,0,65,89,53,36
Norfolk city,517100044003,2020,45546,251,609,12,597
Norfolk city,517100044003,2021,47608,316,588,11,577
Norfolk city,517100045001,2014,62232,1559,199,62,137
Norfolk city,517100045001,2015,47344,1448,258,77,181
Norfolk city,517100045001,2016,47813,1341,340,194,146
Norfolk city,517100045001,2017,53711,1392,330,182,148
Norfolk city,517100045001,2018,57697,1333,344,177,167
Norfolk city,517100045001,2019,58261,1326,258,155,103
Norfolk city,517100045001,2020,72717,1248,416,228,188
Norfolk city,517100045001,2021,75865,1325,198,82,116
Norfolk city,517100046001,2014,37321,722,286,171,115
Norfolk city,517100046001,2015,36372,722,186,156,30
Norfolk city,517100046001,2016,35045,663,242,140,102
Norfolk city,517100046001,2017,37917,659,278,163,115
Norfolk city,517100046001,2018,39844,653,264,89,175
Norfolk city,517100046001,2019,44688,753,215,60,155
Norfolk city,517100046001,2020,53731,902,188,47,141
Norfolk city,517100046001,2021,57479,888,82,51,31
Norfolk city,517100046002,2014,18724,553,530,270,260
Norfolk city,517100046002,2015,17902,589,450,251,199
Norfolk city,517100046002,2016,19583,639,431,240,191
Norfolk city,517100046002,2017,20517,697,454,299,155
Norfolk city,517100046002,2018,19235,670,530,400,130
Norfolk city,517100046002,2019,18165,459,548,343,205
Norfolk city,517100046002,2020,20650,376,663,404,259
Norfolk city,517100046002,2021,20497,386,619,323,296
Norfolk city,517100047001,2016,0,0,0,0,0
Norfolk city,517100047001,2017,0,0,0,0,0
Norfolk city,517100047001,2018,0,0,0,0,0
Norfolk city,517100047001,2019,0,0,0,0,0
Norfolk city,517100047001,2020,0,0,0,0,0
Norfolk city,517100047002,2014,40250,429,89,19,70
Norfolk city,517100047002,2015,48125,574,90,28,62
Norfolk city,517100047002,2016,51667,551,84,27,57
Norfolk city,517100047002,2017,51563,489,113,28,85
Norfolk city,517100047002,2018,51250,403,83,14,69
Norfolk city,517100047002,2019,50568,438,71,12,59
Norfolk city,517100047002,2020,51528,291,54,3,51
Norfolk city,517100047002,2021,52778,216,76,4,72
Norfolk city,517100048001,2014,9755,147,1157,789,368
Norfolk city,517100048001,2015,10032,207,1005,679,326
Norfolk city,517100048001,2016,11394,309,1030,689,341
Norfolk city,517100048001,2017,11900,332,942,537,405
Norfolk city,517100048001,2018,13048,388,952,466,486
Norfolk city,517100048001,2019,14189,498,915,430,485
Norfolk city,517100048001,2020,13442,549,1502,793,709
Norfolk city,517100048001,2021,13356,407,1276,706,570
Norfolk city,517100049001,2014,70809,2761,492,218,274
Norfolk city,517100049001,2015,71636,2691,501,269,232
Norfolk city,517100049001,2016,64565,2720,646,326,320
Norfolk city,517100049001,2017,71406,2805,652,383,269
Norfolk city,517100049001,2018,70435,3222,648,352,296
Norfolk city,517100049001,2019,68565,3391,712,446,266
Norfolk city,517100049001,2020,96711,1823,100,56,44
Norfolk city,517100049001,2021,119634,1808,86,71,15
Norfolk city,517100049002,2016,0,0,0,0,0
Norfolk city,517100049002,2017,0,0,0,0,0
Norfolk city,517100049002,2018,0,0,0,0,0
Norfolk city,517100049002,2019,0,0,0,0,0
Norfolk city,517100049002,2020,0,0,0,0,0
Norfolk city,517100050001,2014,31944,684,372,159,213
Norfolk city,517100050001,2015,31500,869,434,187,247
Norfolk city,517100050001,2016,38150,901,387,92,295
Norfolk city,517100050001,2017,39605,813,339,80,259
Norfolk city,517100050001,2018,42716,814,300,67,233
Norfolk city,517100050001,2019,50357,924,100,29,71
Norfolk city,517100050001,2020,50705,603,171,122,49
Norfolk city,517100050001,2021,46458,783,220,142,78
Norfolk city,517100050002,2014,28688,1079,421,194,227
Norfolk city,517100050002,2015,28393,1005,518,255,263
Norfolk city,517100050002,2016,19185,749,598,369,229
Norfolk city,517100050002,2017,19898,966,577,387,190
Norfolk city,517100050002,2018,20493,919,410,274,136
Norfolk city,517100050002,2019,0,852,273,173,100
Norfolk city,517100050002,2020,40500,843,298,112,186
Norfolk city,517100050002,2021,43750,949,177,11,166
Norfolk city,517100050003,2014,28798,468,250,108,142
Norfolk city,517100050003,2015,27344,452,232,123,109
Norfolk city,517100050003,2016,28864,595,318,243,75
Norfolk city,517100050003,2017,28493,716,235,188,47
Norfolk city,517100050003,2018,27823,787,225,174,51
Norfolk city,517100050003,2019,27011,818,200,130,70
Norfolk city,517100050003,2020,0,795,217,136,81
Norfolk city,517100051001,2014,42833,922,189,34,155
Norfolk city,517100051001,2015,39167,966,170,36,134
Norfolk city,517100051001,2016,42833,910,191,76,115
Norfolk city,517100051001,2017,43144,901,205,82,123
Norfolk city,517100051001,2018,45896,852,112,101,11
Norfolk city,517100051001,2019,45529,700,115,106,9
Norfolk city,517100051001,2020,47159,569,190,105,85
Norfolk city,517100051001,2021,48894,587,143,55,88
Norfolk city,517100051002,2014,38945,1853,349,214,135
Norfolk city,517100051002,2015,40147,1744,369,202,167
Norfolk city,517100051002,2016,40335,1618,469,327,142
Norfolk city,517100051002,2017,40938,1011,451,309,142
Norfolk city,517100051002,2018,47143,1192,329,263,66
Norfolk city,517100051002,2019,45398,1252,355,279,76
Norfolk city,517100051002,2020,33094,1512,328,280,48
Norfolk city,517100051002,2021,32971,1157,224,136,88
Norfolk city,517100051003,2014,12176,279,1304,471,833
Norfolk city,517100051003,2015,12965,295,1651,676,975
Norfolk city,517100051003,2016,15613,412,1470,540,930
Norfolk city,517100051003,2017,16395,545,1699,800,899
Norfolk city,517100051003,2018,16762,493,1627,744,883
Norfolk city,517100051003,2019,24607,622,1337,567,770
Norfolk city,517100051003,2020,16489,468,556,307,249
Norfolk city,517100055001,2014,52574,1049,316,111,205
Norfolk city,517100055001,2015,47375,1029,345,83,262
Norfolk city,517100055001,2016,49750,973,430,215,215
Norfolk city,517100055001,2017,47045,981,563,334,229
Norfolk city,517100055001,2018,47813,751,296,254,42
Norfolk city,517100055001,2019,63646,775,209,150,59
Norfolk city,517100055001,2020,51125,519,181,146,35
Norfolk city,517100055001,2021,52986,641,49,0,49
Norfolk city,517100055002,2014,33125,995,128,55,73
Norfolk city,517100055002,2015,33375,1028,86,29,57
Norfolk city,517100055002,2016,35272,626,86,46,40
Norfolk city,517100055002,2017,46708,690,57,57,0
Norfolk city,517100055002,2018,45962,734,250,202,48
Norfolk city,517100055002,2019,35577,523,265,212,53
Norfolk city,517100055002,2020,36691,670,223,176,47
Norfolk city,517100055002,2021,53636,362,393,284,109
Norfolk city,517100055003,2014,28185,826,538,290,248
Norfolk city,517100055003,2015,41000,770,566,292,274
Norfolk city,517100055003,2016,0,684,690,423,267
Norfolk city,517100055003,2017,58047,850,221,50,171
Norfolk city,517100055003,2018,52222,764,269,57,212
Norfolk city,517100055003,2019,56500,1000,125,29,96
Norfolk city,517100055003,2020,52311,1035,98,29,69
Norfolk city,517100055003,2021,72386,1351,75,21,54
Norfolk city,517100056011,2014,63485,499,16,0,16
Norfolk city,517100056011,2015,63580,588,56,22,34
Norfolk city,517100056011,2016,70609,595,46,30,16
Norfolk city,517100056011,2017,74637,472,50,39,11
Norfolk city,517100056011,2018,73705,453,63,50,13
Norfolk city,517100056011,2019,77563,434,56,46,10
Norfolk city,517100056011,2020,77639,435,26,26,0
Norfolk city,517100056011,2021,73553,491,23,23,0
Norfolk city,517100056012,2014,70795,687,0,0,0
Norfolk city,517100056012,2015,61983,471,0,0,0
Norfolk city,517100056012,2016,64167,519,0,0,0
Norfolk city,517100056012,2017,76912,431,36,0,36
Norfolk city,517100056012,2018,66587,510,39,0,39
Norfolk city,517100056012,2019,66513,538,36,0,36
Norfolk city,517100056012,2020,69042,436,30,0,30
Norfolk city,517100056012,2021,72257,389,34,0,34
Norfolk city,517100056013,2014,61887,1210,115,73,42
Norfolk city,517100056013,2015,62500,1416,168,65,103
Norfolk city,517100056013,2016,63125,1520,267,69,198
Norfolk city,517100056013,2017,62000,1423,200,15,185
Norfolk city,517100056013,2018,64242,1187,197,18,179
Norfolk city,517100056013,2019,61818,1085,220,20,200
Norfolk city,517100056013,2020,65991,1165,122,7,115
Norfolk city,517100056013,2021,68500,997,15,15,0
Norfolk city,517100056014,2014,47625,1381,451,213,238
Norfolk city,517100056014,2015,46838,1329,407,242,165
Norfolk city,517100056014,2016,60000,1241,336,215,121
Norfolk city,517100056014,2017,70278,1611,353,217,136
Norfolk city,517100056014,2018,68906,1797,185,67,118
Norfolk city,517100056014,2019,74167,1920,143,68,75
Norfolk city,517100056014,2020,69042,2075,97,68,29
Norfolk city,517100056014,2021,74199,2041,93,64,29
Norfolk city,517100056021,2014,47109,1284,17,7,10
Norfolk city,517100056021,2015,65000,1354,61,51,10
Norfolk city,517100056021,2016,65120,1218,167,48,119
Norfolk city,517100056021,2017,68482,1291,188,60,128
Norfolk city,517100056021,2018,55486,1171,214,91,123
Norfolk city,517100056021,2019,67386,1168,194,76,118
Norfolk city,517100056021,2020,68064,1124,141,19,122
Norfolk city,517100056021,2021,72157,1228,14,14,0
Norfolk city,517100056022,2014,29907,704,325,122,203
Norfolk city,517100056022,2015,30000,650,397,222,175
Norfolk city,517100056022,2016,35142,1008,557,457,100
Norfolk city,517100056022,2017,41528,1175,434,355,79
Norfolk city,517100056022,2018,41875,1298,340,296,44
Norfolk city,517100056022,2019,44432,1250,323,293,30
Norfolk city,517100056022,2020,51058,1257,241,228,13
Norfolk city,517100056022,2021,61413,1252,156,125,31
Norfolk city,517100056023,2014,56660,758,118,35,83
Norfolk city,517100056023,2015,61724,856,105,37,68
Norfolk city,517100056023,2016,70761,762,85,15,70
Norfolk city,517100056023,2017,66528,689,29,18,11
Norfolk city,517100056023,2018,69444,863,23,10,13
Norfolk city,517100056023,2019,69432,786,52,32,20
Norfolk city,517100056023,2020,66071,626,57,30,27
Norfolk city,517100056023,2021,76696,511,53,45,8
Norfolk city,517100057011,2014,33213,2279,543,247,296
Norfolk city,517100057011,2015,35431,2272,400,245,155
Norfolk city,517100057011,2016,38315,2550,377,220,157
Norfolk city,517100057011,2017,47846,2096,455,190,265
Norfolk city,517100057011,2018,49963,2297,305,10,295
Norfolk city,517100057011,2019,36738,1724,665,18,647
Norfolk city,517100057011,2020,34476,1014,404,0,404
Norfolk city,517100057011,2021,49196,1044,455,0,455
Norfolk city,517100057012,2014,35612,570,241,149,92
Norfolk city,517100057012,2015,29234,632,616,169,447
Norfolk city,517100057012,2016,27315,608,587,156,431
Norfolk city,517100057012,2017,29021,688,797,172,625
Norfolk city,517100057012,2018,29507,795,615,147,468
Norfolk city,517100057012,2019,35379,1155,703,67,636
Norfolk city,517100057012,2020,36451,1102,262,193,69
Norfolk city,517100057012,2021,45662,872,234,187,47
Norfolk city,517100057013,2014,22043,1071,559,289,270
Norfolk city,517100057013,2015,25278,852,494,286,208
Norfolk city,517100057013,2016,23930,717,400,229,171
Norfolk city,517100057013,2017,23394,683,371,210,161
Norfolk city,517100057013,2018,35175,876,238,161,77
Norfolk city,517100057013,2019,35231,675,115,100,15
Norfolk city,517100057013,2020,32992,469,283,220,63
Norfolk city,517100057013,2021,34554,422,245,193,52
Norfolk city,517100057021,2014,47778,1444,144,10,134
Norfolk city,517100057021,2015,40000,1321,209,20,189
Norfolk city,517100057021,2016,35156,1288,91,31,60
Norfolk city,517100057021,2017,24590,1099,224,40,184
Norfolk city,517100057021,2018,32042,1304,146,27,119
Norfolk city,517100057021,2019,40563,1177,173,40,133
Norfolk city,517100057021,2020,78964,1461,252,9,243
Norfolk city,517100057021,2021,87985,1657,160,0,160
Norfolk city,517100057022,2014,45500,812,109,32,77
Norfolk city,517100057022,2015,43571,769,136,33,103
Norfolk city,517100057022,2016,46471,777,146,64,82
Norfolk city,517100057022,2017,49755,805,167,57,110
Norfolk city,517100057022,2018,64271,839,96,0,96
Norfolk city,517100057022,2019,59643,859,337,0,337
Norfolk city,517100057022,2020,58125,836,314,0,314
Norfolk city,517100057022,2021,55417,729,429,0,429
Norfolk city,517100058001,2014,37463,998,372,186,186
Norfolk city,517100058001,2015,37012,799,423,162,261
Norfolk city,517100058001,2016,39146,785,429,158,271
Norfolk city,517100058001,2017,46090,1085,403,209,194
Norfolk city,517100058001,2018,41213,1188,340,171,169
Norfolk city,517100058001,2019,47895,1433,249,158,91
Norfolk city,517100058001,2020,47188,1273,262,216,46
Norfolk city,517100058001,2021,39958,1185,443,267,176
Norfolk city,517100058002,2014,25263,1566,418,119,299
Norfolk city,517100058002,2015,22089,1431,482,110,372
Norfolk city,517100058002,2016,23843,1379,494,58,436
Norfolk city,517100058002,2017,24757,1402,394,37,357
Norfolk city,517100058002,2018,33667,1567,427,25,402
Norfolk city,517100058002,2019,35438,1654,340,18,322
Norfolk city,517100058002,2020,54088,1814,234,18,216
Norfolk city,517100058002,2021,62188,1760,180,21,159
Norfolk city,517100058003,2014,71250,1195,288,39,249
Norfolk city,517100058003,2015,62375,1092,292,39,253
Norfolk city,517100058003,2016,62264,1093,363,87,276
Norfolk city,517100058003,2017,64556,1082,292,91,201
Norfolk city,517100058003,2018,68264,1089,293,129,164
Norfolk city,517100058003,2019,71094,892,190,173,17
Norfolk city,517100058003,2020,77939,870,158,148,10
Norfolk city,517100058003,2021,74896,735,130,0,130
Norfolk city,517100059011,2014,27986,1280,197,75,122
Norfolk city,517100059011,2015,37333,1211,122,15,107
Norfolk city,517100059011,2016,48417,1096,97,43,54
Norfolk city,517100059011,2017,51179,1048,86,39,47
Norfolk city,517100059011,2018,46944,951,191,43,148
Norfolk city,517100059011,2019,51964,954,232,57,175
Norfolk city,517100059011,2020,38824,864,172,67,105
Norfolk city,517100059011,2021,31250,680,318,119,199
Norfolk city,517100059012,2014,45108,1902,321,76,245
Norfolk city,517100059012,2015,45294,1929,345,96,249
Norfolk city,517100059012,2016,45632,2075,567,301,266
Norfolk city,517100059012,2017,46896,2049,640,415,225
Norfolk city,517100059012,2018,48179,2168,566,429,137
Norfolk city,517100059012,2019,52861,2061,661,490,171
Norfolk city,517100059012,2020,23510,1146,691,279,412
Norfolk city,517100059012,2021,23750,1100,704,323,381
Norfolk city,517100059013,2014,28616,1177,377,183,194
Norfolk city,517100059013,2015,28371,1160,174,105,69
Norfolk city,517100059013,2016,28600,1318,279,89,190
Norfolk city,517100059013,2017,30862,1285,434,155,279
Norfolk city,517100059013,2018,30729,1262,501,148,353
Norfolk city,517100059013,2019,33382,1181,618,205,413
Norfolk city,517100059013,2020,46274,586,350,334,16
Norfolk city,517100059013,2021,48113,350,171,154,17
Norfolk city,517100059021,2014,59773,594,0,0,0
Norfolk city,517100059021,2015,61250,650,8,8,0
Norfolk city,517100059021,2016,72552,713,10,10,0
Norfolk city,517100059021,2017,66458,778,144,24,120
Norfolk city,517100059021,2018,59476,801,232,24,208
Norfolk city,517100059021,2019,69013,672,276,30,246
Norfolk city,517100059021,2020,70690,692,271,16,255
Norfolk city,517100059021,2021,85795,626,271,7,264
Norfolk city,517100059022,2014,51641,803,166,89,77
Norfolk city,517100059022,2015,46513,610,126,34,92
Norfolk city,517100059022,2016,42016,715,125,0,125
Norfolk city,517100059022,2017,43185,890,109,0,109
Norfolk city,517100059022,2018,50956,977,208,177,31
Norfolk city,517100059022,2019,50772,962,241,210,31
Norfolk city,517100059022,2020,51930,1031,204,186,18
Norfolk city,517100059022,2021,54824,1070,146,127,19
Norfolk city,517100059023,2014,58300,695,254,56,198
Norfolk city,517100059023,2015,57045,803,259,59,200
Norfolk city,517100059023,2016,59095,644,216,74,142
Norfolk city,517100059023,2017,60650,505,217,12,205
Norfolk city,517100059023,2018,59561,482,11,11,0
Norfolk city,517100059023,2019,70424,628,5,5,0
Norfolk city,517100059023,2020,71042,339,8,8,0
Norfolk city,517100059023,2021,57969,381,0,0,0
Norfolk city,517100059024,2014,41132,1008,115,7,108
Norfolk city,517100059024,2015,37750,1006,216,6,210
Norfolk city,517100059024,2016,41941,1090,184,9,175
Norfolk city,517100059024,2017,40375,1054,194,7,187
Norfolk city,517100059024,2018,43125,1212,213,9,204
Norfolk city,517100059024,2019,39358,1001,165,7,158
Norfolk city,517100059024,2020,38359,949,60,6,54
Norfolk city,517100059024,2021,45556,1202,82,51,31
Norfolk city,517100059031,2014,45900,759,154,77,77
Norfolk city,517100059031,2015,46080,732,170,106,64
Norfolk city,517100059031,2016,39200,705,145,119,26
Norfolk city,517100059031,2017,36000,771,144,114,30
Norfolk city,517100059031,2018,37167,794,167,118,49
Norfolk city,517100059031,2019,34643,930,136,76,60
Norfolk city,517100059031,2020,38500,899,99,40,59
Norfolk city,517100059031,2021,51563,818,132,52,80
Norfolk city,517100059032,2014,52232,831,38,11,27
Norfolk city,517100059032,2015,51728,708,46,20,26
Norfolk city,517100059032,2016,53224,716,106,71,35
Norfolk city,517100059032,2017,53491,737,101,76,25
Norfolk city,517100059032,2018,57250,799,74,74,0
Norfolk city,517100059032,2019,56818,684,55,55,0
Norfolk city,517100059032,2020,61607,635,67,67,0
Norfolk city,517100059032,2021,81000,574,30,30,0
Norfolk city,517100060001,2014,53110,1005,235,39,196
Norfolk city,517100060001,2015,53011,994,265,82,183
Norfolk city,517100060001,2016,46250,926,344,115,229
Norfolk city,517100060001,2017,33365,957,354,116,238
Norfolk city,517100060001,2018,37228,709,147,134,13
Norfolk city,517100060001,2019,44625,642,88,76,12
Norfolk city,517100060001,2020,39196,791,100,100,0
Norfolk city,517100060001,2021,45313,1008,80,80,0
Norfolk city,517100060002,2014,47813,758,227,74,153
Norfolk city,517100060002,2015,42647,884,284,83,201
Norfolk city,517100060002,2016,48750,923,245,63,182
Norfolk city,517100060002,2017,52500,962,257,70,187
Norfolk city,517100060002,2018,57688,1253,319,46,273
Norfolk city,517100060002,2019,58000,1208,276,39,237
Norfolk city,517100060002,2020,85341,1193,48,0,48
Norfolk city,517100060002,2021,73869,1221,51,0,51
Norfolk city,517100060003,2014,40982,1104,396,194,202
Norfolk city,517100060003,2015,38438,1059,284,195,89
Norfolk city,517100060003,2016,41417,1233,277,212,65
Norfolk city,517100060003,2017,46563,1237,180,98,82
Norfolk city,517100060003,2018,46705,1308,140,44,96
Norfolk city,517100060003,2019,52237,1426,198,44,154
Norfolk city,517100060003,2020,49489,1322,175,64,111
Norfolk city,517100060003,2021,40987,974,99,44,55
Norfolk city,517100061001,2014,33899,1290,449,388,61
Norfolk city,517100061001,2015,34066,1574,629,538,91
Norfolk city,517100061001,2016,34462,1753,586,532,54
Norfolk city,517100061001,2017,34942,1571,637,540,97
Norfolk city,517100061001,2018,42350,1770,689,582,107
Norfolk city,517100061001,2019,44898,2157,442,212,230
Norfolk city,517100061001,2020,46771,2326,271,73,198
Norfolk city,517100061001,2021,63646,2143,257,95,162
Norfolk city,517100061002,2014,56094,1613,353,323,30
Norfolk city,517100061002,2015,52500,1734,321,292,29
Norfolk city,517100061002,2016,49868,1557,103,78,25
Norfolk city,517100061002,2017,51820,1521,45,0,45
Norfolk city,517100061002,2018,52005,1566,80,0,80
Norfolk city,517100061002,2019,58366,1546,64,0,64
Norfolk city,517100061002,2020,75656,2244,64,0,64
Norfolk city,517100061002,2021,80075,2314,188,97,91
Norfolk city,517100061003,2014,61016,1272,265,193,72
Norfolk city,517100061003,2015,60234,1271,230,169,61
Norfolk city,517100061003,2016,32400,981,223,167,56
Norfolk city,517100061003,2017,38173,1001,249,144,105
Norfolk city,517100061003,2018,33700,1050,256,167,89
Norfolk city,517100061003,2019,71985,1271,85,0,85
Norfolk city,517100061003,2020,0,1301,77,0,77
Norfolk city,517100061004,2014,48270,1521,265,169,96
Norfolk city,517100061004,2015,48596,1160,322,158,164
Norfolk city,517100061004,2016,53239,1399,179,68,111
Norfolk city,517100061004,2017,61250,1456,120,0,120
Norfolk city,517100061004,2018,56967,1223,207,0,207
Norfolk city,517100061004,2019,70298,1233,267,68,199
Norfolk city,517100061004,2020,71836,1714,260,58,202
Norfolk city,517100061004,2021,62212,1422,231,58,173
Norfolk city,517100061005,2014,39904,489,171,34,137
Norfolk city,517100061005,2015,41938,410,191,29,162
Norfolk city,517100061005,2016,41696,448,208,21,187
Norfolk city,517100061005,2017,0,552,250,41,209
Norfolk city,517100061005,2018,41335,490,122,45,77
Norfolk city,517100061005,2019,31103,410,161,16,145
Norfolk city,517100061005,2020,27222,347,122,17,105
Norfolk city,517100062001,2014,38807,1224,240,99,141
Norfolk city,517100062001,2015,38333,1290,86,53,33
Norfolk city,517100062001,2016,38347,1355,60,18,42
Norfolk city,517100062001,2017,37857,1001,121,37,84
Norfolk city,517100062001,2018,47500,1143,114,16,98
Norfolk city,517100062001,2019,57903,976,70,28,42
Norfolk city,517100062001,2020,41915,924,59,31,28
Norfolk city,517100062001,2021,45288,836,72,35,37
Norfolk city,517100062002,2014,56923,1215,102,30,72
Norfolk city,517100062002,2015,58438,1336,96,12,84
Norfolk city,517100062002,2016,48929,1304,192,88,104
Norfolk city,517100062002,2017,46935,1503,328,216,112
Norfolk city,517100062002,2018,49911,1546,288,189,99
Norfolk city,517100062002,2019,48510,1792,243,174,69
Norfolk city,517100062002,2020,50469,1578,245,180,65
Norfolk city,517100062002,2021,52734,1606,279,103,176
Norfolk city,517100064001,2014,67813,1672,240,35,205
Norfolk city,517100064001,2015,69635,1613,232,65,167
Norfolk city,517100064001,2016,70362,1477,242,61,181
Norfolk city,517100064001,2017,71292,1399,124,70,54
Norfolk city,517100064001,2018,75792,1594,146,91,55
Norfolk city,517100064001,2019,76316,1272,98,68,30
Norfolk city,517100064001,2020,80441,1275,66,36,30
Norfolk city,517100064001,2021,93409,1052,83,46,37
Norfolk city,517100064002,2014,35391,1478,510,272,238
Norfolk city,517100064002,2015,36191,1445,643,325,318
Norfolk city,517100064002,2016,35323,1376,623,292,331
Norfolk city,517100064002,2017,30385,1401,460,216,244
Norfolk city,517100064002,2018,31484,1223,546,128,418
Norfolk city,517100064002,2019,27224,1342,632,165,467
Norfolk city,517100064002,2020,27296,1207,368,102,266
Norfolk city,517100064002,2021,28663,1193,471,170,301
Norfolk city,517100065011,2014,43500,1133,588,326,262
Norfolk city,517100065011,2015,39297,961,624,309,315
Norfolk city,517100065011,2016,38788,983,654,317,337
Norfolk city,517100065011,2017,40699,921,625,282,343
Norfolk city,517100065011,2018,55556,1021,269,47,222
Norfolk city,517100065011,2019,55375,944,175,48,127
Norfolk city,517100065011,2020,33917,1007,141,96,45
Norfolk city,517100065011,2021,37398,1160,132,92,40
Norfolk city,517100065012,2014,32054,1037,450,160,290
Norfolk city,517100065012,2015,32770,1174,512,169,343
Norfolk city,517100065012,2016,34756,1108,422,151,271
Norfolk city,517100065012,2017,32688,1094,389,168,221
Norfolk city,517100065012,2018,32664,1022,360,204,156
Norfolk city,517100065012,2019,34861,1120,221,84,137
Norfolk city,517100065012,2020,36779,849,132,108,24
Norfolk city,517100065012,2021,36568,887,231,104,127
Norfolk city,517100065021,2014,112206,1189,22,22,0
Norfolk city,517100065021,2015,112353,1424,37,37,0
Norfolk city,517100065021,2016,120972,1814,37,37,0
Norfolk city,517100065021,2017,127159,1867,39,39,0
Norfolk city,517100065021,2018,126944,1749,92,48,44
Norfolk city,517100065021,2019,166780,2003,47,32,15
Norfolk city,517100065021,2020,192917,618,0,0,0
Norfolk city,517100065021,2021,175446,641,0,0,0
Norfolk city,517100065022,2014,33006,1173,710,266,444
Norfolk city,517100065022,2015,18456,890,622,246,376
Norfolk city,517100065022,2016,16818,781,621,275,346
Norfolk city,517100065022,2017,17229,557,824,344,480
Norfolk city,517100065022,2018,19008,701,639,314,325
Norfolk city,517100065022,2019,24773,745,515,276,239
Norfolk city,517100065022,2020,128750,1144,10,0,10
Norfolk city,517100065022,2021,112813,904,14,0,14
Norfolk city,517100066011,2014,59063,869,197,2,195
Norfolk city,517100066011,2015,64167,861,132,2,130
Norfolk city,517100066011,2016,59922,538,131,4,127
Norfolk city,517100066011,2017,61389,574,114,10,104
Norfolk city,517100066011,2018,65714,589,130,9,121
Norfolk city,517100066011,2019,75368,589,28,11,17
Norfolk city,517100066011,2020,76250,426,45,30,15
Norfolk city,517100066011,2021,84097,462,55,34,21
Norfolk city,517100066021,2014,59688,644,96,16,80
Norfolk city,517100066021,2015,63375,536,75,27,48
Norfolk city,517100066021,2016,60833,516,84,30,54
Norfolk city,517100066021,2017,66250,522,59,43,16
Norfolk city,517100066021,2018,71518,503,41,36,5
Norfolk city,517100066021,2019,79250,496,22,18,4
Norfolk city,517100066021,2020,73984,504,17,12,5
Norfolk city,517100066021,2021,77130,445,13,8,5
Norfolk city,517100066022,2014,58417,1678,58,47,11
Norfolk city,517100066022,2015,59167,1769,93,80,13
Norfolk city,517100066022,2016,58785,1767,191,175,16
Norfolk city,517100066022,2017,58456,1762,196,181,15
Norfolk city,517100066022,2018,59861,1797,198,178,20
Norfolk city,517100066022,2019,61786,1736,216,160,56
Norfolk city,517100066022,2020,63992,1730,391,173,218
Norfolk city,517100066022,2021,80987,1760,307,123,184
Norfolk city,517100066031,2014,59167,1380,80,60,20
Norfolk city,517100066031,2015,59250,1129,93,66,27
Norfolk city,517100066031,2016,61591,1053,102,71,31
Norfolk city,517100066031,2017,63500,1150,98,60,38
Norfolk city,517100066031,2018,61779,1003,89,39,50
Norfolk city,517100066031,2019,64167,1007,91,43,48
Norfolk city,517100066031,2020,53875,941,81,31,50
Norfolk city,517100066031,2021,59803,990,85,42,43
Norfolk city,517100066032,2014,53750,928,194,20,174
Norfolk city,517100066032,2015,55208,1080,180,20,160
Norfolk city,517100066032,2016,51131,875,245,14,231
Norfolk city,517100066032,2017,53000,852,215,14,201
Norfolk city,517100066032,2018,60234,894,85,10,75
Norfolk city,517100066032,2019,65833,880,112,22,90
Norfolk city,517100066032,2020,60179,810,93,27,66
Norfolk city,517100066032,2021,70109,838,58,52,6
Norfolk city,517100066041,2014,39263,1692,515,341,174
Norfolk city,517100066041,2015,44911,1874,387,292,95
Norfolk city,517100066041,2016,43813,1734,425,342,83
Norfolk city,517100066041,2017,44375,1731,378,300,78
Norfolk city,517100066041,2018,46915,1694,327,179,148
Norfolk city,517100066041,2019,53041,1910,428,163,265
Norfolk city,517100066041,2020,64464,627,65,12,53
Norfolk city,517100066041,2021,82917,736,73,18,55
Norfolk city,517100066051,2014,65982,983,92,73,19
Norfolk city,517100066051,2015,65474,1041,102,83,19
Norfolk city,517100066051,2016,66094,878,80,71,9
Norfolk city,517100066051,2017,66875,1080,55,45,10
Norfolk city,517100066051,2018,70536,888,57,46,11
Norfolk city,517100066051,2019,69327,1006,50,41,9
Norfolk city,517100066051,2020,78000,1094,43,33,10
Norfolk city,517100066051,2021,86125,1069,30,30,0
Norfolk city,517100066052,2014,50476,1516,126,96,30
Norfolk city,517100066052,2015,49756,1455,141,116,25
Norfolk city,517100066052,2016,52092,1656,133,115,18
Norfolk city,517100066052,2017,51557,1559,128,106,22
Norfolk city,517100066052,2018,53051,1787,162,156,6
Norfolk city,517100066052,2019,52905,1586,76,70,6
Norfolk city,517100066052,2020,53293,1510,61,55,6
Norfolk city,517100066052,2021,64597,1402,43,33,10
Norfolk city,517100066061,2014,41461,979,318,20,298
Norfolk city,517100066061,2015,33922,1238,248,18,230
Norfolk city,517100066061,2016,41905,1513,254,16,238
Norfolk city,517100066061,2017,38309,1574,123,25,98
Norfolk city,517100066061,2018,35888,1708,168,26,142
Norfolk city,517100066061,2019,36106,1589,123,25,98
Norfolk city,517100066061,2020,39375,1449,144,54,90
Norfolk city,517100066061,2021,37925,1294,149,70,79
Norfolk city,517100066062,2014,78636,1048,107,78,29
Norfolk city,517100066062,2015,82955,1191,108,85,23
Norfolk city,517100066062,2016,88125,1167,84,61,23
Norfolk city,517100066062,2017,83393,1042,63,51,12
Norfolk city,517100066062,2018,98571,883,15,2,13
Norfolk city,517100066062,2019,117903,912,13,4,9
Norfolk city,517100066062,2020,71731,834,11,4,7
Norfolk city,517100066062,2021,79286,628,9,1,8
Norfolk city,517100066063,2014,58179,797,75,26,49
Norfolk city,517100066063,2015,52016,616,194,32,162
Norfolk city,517100066063,2016,48971,410,158,30,128
Norfolk city,517100066063,2017,45694,415,195,57,138
Norfolk city,517100066063,2018,50486,407,208,49,159
Norfolk city,517100066063,2019,60260,543,210,37,173
Norfolk city,517100066063,2020,60875,390,83,32,51
Norfolk city,517100066063,2021,83397,640,93,41,52
Norfolk city,517100066064,2014,51339,593,130,0,130
Norfolk city,517100066064,2015,52700,522,26,0,26
Norfolk city,517100066064,2016,53571,503,80,0,80
Norfolk city,517100066064,2017,54904,555,60,0,60
Norfolk city,517100066064,2018,59583,515,63,0,63
Norfolk city,517100066064,2019,66917,526,57,0,57
Norfolk city,517100066064,2020,80714,501,49,0,49
Norfolk city,517100066064,2021,117596,580,9,9,0
Norfolk city,517100066071,2014,53036,1106,131,69,62
Norfolk city,517100066071,2015,63548,1008,113,40,73
Norfolk city,517100066071,2016,82650,1384,123,61,62
Norfolk city,517100066071,2017,84167,1421,45,39,6
Norfolk city,517100066071,2018,86190,1347,39,33,6
Norfolk city,517100066071,2019,86806,1083,39,39,0
Norfolk city,517100066071,2020,88182,1344,31,31,0
Norfolk city,517100066071,2021,78056,1191,14,3,11
Norfolk city,517100066072,2014,46875,672,51,51,0
Norfolk city,517100066072,2015,56042,916,56,56,0
Norfolk city,517100066072,2016,50250,963,83,65,18
Norfolk city,517100066072,2017,50870,983,297,62,235
Norfolk city,517100066072,2018,50855,925,284,30,254
Norfolk city,517100066072,2019,53017,927,183,7,176
Norfolk city,517100066072,2020,51289,585,178,9,169
Norfolk city,517100066072,2021,58241,635,228,8,220
Norfolk city,517100066073,2014,56111,920,19,19,0
Norfolk city,517100066073,2015,55307,754,21,21,0
Norfolk city,517100066073,2016,56361,536,27,27,0
Norfolk city,517100066073,2017,46429,452,0,0,0
Norfolk city,517100066073,2018,46736,559,43,43,0
Norfolk city,517100066073,2019,49323,680,46,46,0
Norfolk city,517100066073,2020,60592,715,54,54,0
Norfolk city,517100066073,2021,49068,589,92,92,0
Norfolk city,517100068001,2014,61563,202,17,11,6
Norfolk city,517100068001,2015,60938,101,18,12,6
Norfolk city,517100068001,2016,120329,186,14,8,6
Norfolk city,517100068001,2017,122969,155,5,0,5
Norfolk city,517100068001,2018,124861,235,0,0,0
Norfolk city,517100068001,2019,128333,249,0,0,0
Norfolk city,517100068001,2020,63507,1471,285,45,240
Norfolk city,517100068001,2021,64387,1367,328,29,299
Norfolk city,517100068002,2014,62269,1433,231,122,109
Norfolk city,517100068002,2015,61207,1436,264,175,89
Norfolk city,517100068002,2016,51205,1479,249,159,90
Norfolk city,517100068002,2017,50958,1463,256,157,99
Norfolk city,517100068002,2018,53792,1370,185,102,83
Norfolk city,517100068002,2019,54692,1423,109,22,87
Norfolk city,517100069011,2014,33781,1013,447,174,273
Norfolk city,517100069011,2015,33750,851,376,244,132
Norfolk city,517100069011,2016,29814,812,414,263,151
Norfolk city,517100069011,2017,37415,942,310,199,111
Norfolk city,517100069011,2018,0,817,59,36,23
Norfolk city,517100069011,2019,44740,422,28,0,28
Norfolk city,517100069011,2020,60781,416,25,0,25
Norfolk city,517100069011,2021,70296,471,26,0,26
Norfolk city,517100069012,2014,40000,687,126,25,101
Norfolk city,517100069012,2015,49904,764,153,23,130
Norfolk city,517100069012,2016,58929,733,48,1,47
Norfolk city,517100069012,2017,59637,701,101,71,30
Norfolk city,517100069012,2018,65135,827,134,77,57
Norfolk city,517100069012,2019,50096,804,108,55,53
Norfolk city,517100069012,2020,60045,655,135,77,58
Norfolk city,517100069012,2021,51625,588,156,86,70
Norfolk city,517100069013,2014,62451,1352,129,0,129
Norfolk city,517100069013,2015,61521,1508,113,7,106
Norfolk city,517100069013,2016,60612,1500,52,9,43
Norfolk city,517100069013,2017,62936,1463,141,59,82
Norfolk city,517100069013,2018,58306,1589,83,65,18
Norfolk city,517100069013,2019,62500,1630,64,52,12
Norfolk city,517100069013,2020,59565,1531,184,107,77
Norfolk city,517100069013,2021,63984,1531,233,120,113
Norfolk city,517100069021,2014,42826,736,409,43,366
Norfolk city,517100069021,2015,48839,971,187,44,143
Norfolk city,517100069021,2016,52128,998,171,42,129
Norfolk city,517100069021,2017,53627,1068,171,90,81
Norfolk city,517100069021,2018,73098,1163,277,193,84
Norfolk city,517100069021,2019,71538,1141,284,151,133
Norfolk city,517100069021,2020,90439,1021,253,163,90
Norfolk city,517100069021,2021,90729,938,223,183,40
Norfolk city,517100069022,2014,48385,1038,124,52,72
Norfolk city,517100069022,2015,47526,1112,130,62,68
Norfolk city,517100069022,2016,49677,1142,55,43,12
Norfolk city,517100069022,2017,51292,1171,51,24,27
Norfolk city,517100069022,2018,64583,1181,75,34,41
Norfolk city,517100069022,2019,70729,1250,46,10,36
Norfolk city,517100069022,2020,52168,1209,109,74,35
Norfolk city,517100069022,2021,52150,1233,138,108,30
Norfolk city,517100070011,2014,45871,1578,215,96,119
Norfolk city,517100070011,2015,52961,1474,147,58,89
Norfolk city,517100070011,2016,54250,1415,174,80,94
Norfolk city,517100070011,2017,51528,1631,111,84,27
Norfolk city,517100070011,2018,43140,1660,129,61,68
Norfolk city,517100070011,2019,47847,1620,242,88,154
Norfolk city,517100070011,2020,46892,1847,326,131,195
Norfolk city,517100070011,2021,53594,1946,371,203,168
Norfolk city,517100070021,2014,46726,1747,394,87,307
Norfolk city,517100070021,2015,32442,1657,493,194,299
Norfolk city,517100070021,2016,33883,1591,513,257,256
Norfolk city,517100070021,2017,34375,1417,485,205,280
Norfolk city,517100070021,2018,61152,1727,455,230,225
Norfolk city,517100070021,2019,77746,1509,190,179,11
Norfolk city,517100070021,2020,64569,1712,184,138,46
Norfolk city,517100070021,2021,69539,1567,158,140,18
Norfolk city,517100070022,2014,49861,1583,123,49,74
Norfolk city,517100070022,2015,45313,1322,158,64,94
Norfolk city,517100070022,2016,47679,1489,153,84,69
Norfolk city,517100070022,2017,50875,1599,132,91,41
Norfolk city,517100070022,2018,52500,1461,120,78,42
Norfolk city,517100070022,2019,62931,1831,93,46,47
Norfolk city,517100070022,2020,76719,1911,59,20,39
Norfolk city,517100070022,2021,82339,1828,71,13,58
Norfolk city,517109801001,2016,0,0,0,0,0
Norfolk city,517109801001,2017,0,0,0,0,0
Norfolk city,517109801001,2018,0,0,0,0,0
Norfolk city,517109801001,2019,0,0,0,0,0
Norfolk city,517109801001,2020,0,0,0,0,0
Norfolk city,517109802001,2016,0,0,0,0,0
Norfolk city,517109802001,2017,0,0,0,0,0
Norfolk city,517109802001,2018,0,0,0,0,0
Norfolk city,517109802001,2019,0,0,0,0,0
Norfolk city,517109802001,2020,0,0,0,0,0
Norfolk city,517109803001,2016,0,0,0,0,0
Norfolk city,517109803001,2017,0,0,0,0,0
Norfolk city,517109803001,2018,0,0,0,0,0
Norfolk city,517109803001,2019,0,0,0,0,0
Norfolk city,517109803001,2020,0,0,0,0,0
Norfolk city,517109900000,2016,0,0,0,0,0
Norfolk city,517109900000,2017,0,0,0,0,0
Norfolk city,517109900000,2018,0,0,0,0,0
Norfolk city,517109900000,2019,0,0,0,0,0
Norfolk city,517109900000,2020,0,0,0,0,0
Virginia Beach city,518100400001,2015,88125,90,0,0,0
Virginia Beach city,518100400001,2016,90658,94,0,0,0
Virginia Beach city,518100400001,2017,91118,108,13,13,0
Virginia Beach city,518100400001,2018,93819,170,12,12,0
Virginia Beach city,518100400001,2019,87222,142,17,17,0
Virginia Beach city,518100400001,2020,113542,177,15,15,0
Virginia Beach city,518100400001,2021,91964,228,19,19,0
Virginia Beach city,518100400002,2014,46023,1203,137,53,84
Virginia Beach city,518100400002,2015,50438,1298,127,43,84
Virginia Beach city,518100400002,2016,51696,1378,174,49,125
Virginia Beach city,518100400002,2017,57768,1418,106,17,89
Virginia Beach city,518100400002,2018,61510,1259,91,33,58
Virginia Beach city,518100400002,2019,64554,1288,74,38,36
Virginia Beach city,518100400002,2020,58250,1207,77,42,35
Virginia Beach city,518100400002,2021,54643,1151,69,69,0
Virginia Beach city,518100402001,2014,34205,1177,429,102,327
Virginia Beach city,518100402001,2015,41000,1199,393,75,318
Virginia Beach city,518100402001,2016,42014,1408,395,28,367
Virginia Beach city,518100402001,2017,46434,1504,372,25,347
Virginia Beach city,518100402001,2018,50893,1784,344,28,316
Virginia Beach city,518100402001,2019,53135,1812,311,38,273
Virginia Beach city,518100402001,2020,54277,1658,324,31,293
Virginia Beach city,518100402001,2021,57031,1417,558,33,525
Virginia Beach city,518100402002,2014,34792,1278,327,228,99
Virginia Beach city,518100402002,2015,39524,1259,382,295,87
Virginia Beach city,518100402002,2016,37457,1206,414,303,111
Virginia Beach city,518100402002,2017,38214,1047,433,284,149
Virginia Beach city,518100402002,2018,50662,1179,370,184,186
Virginia Beach city,518100402002,2019,50161,1360,322,129,193
Virginia Beach city,518100402002,2020,40429,1302,657,347,310
Virginia Beach city,518100402002,2021,44375,1500,434,389,45
Virginia Beach city,518100402003,2014,50573,912,360,156,204
Virginia Beach city,518100402003,2015,51354,877,138,108,30
Virginia Beach city,518100402003,2016,55000,991,126,98,28
Virginia Beach city,518100402003,2017,57107,1061,95,65,30
Virginia Beach city,518100402003,2018,49914,852,75,38,37
Virginia Beach city,518100402003,2019,42670,783,95,53,42
Virginia Beach city,518100402003,2020,38229,700,50,13,37
Virginia Beach city,518100402003,2021,31544,601,72,16,56
Virginia Beach city,518100404021,2014,34596,1911,597,312,285
Virginia Beach city,518100404021,2015,34053,1941,617,313,304
Virginia Beach city,518100404021,2016,40022,2364,422,156,266
Virginia Beach city,518100404021,2017,38041,2680,464,171,293
Virginia Beach city,518100404021,2018,36867,2634,297,141,156
Virginia Beach city,518100404021,2019,37662,2766,358,235,123
Virginia Beach city,518100404022,2014,63678,1731,186,56,130
Virginia Beach city,518100404022,2015,63872,1290,156,92,64
Virginia Beach city,518100404022,2016,63490,1640,178,116,62
Virginia Beach city,518100404022,2017,65968,1215,209,139,70
Virginia Beach city,518100404022,2018,68641,1682,153,89,64
Virginia Beach city,518100404022,2019,70411,1660,330,300,30
Virginia Beach city,518100404023,2014,37708,1625,152,41,111
Virginia Beach city,518100404023,2015,37054,1673,216,63,153
Virginia Beach city,518100404023,2016,34950,1689,220,68,152
Virginia Beach city,518100404023,2017,36219,1465,302,93,209
Virginia Beach city,518100404023,2018,35729,1219,233,86,147
Virginia Beach city,518100404023,2019,71103,987,197,39,158
Virginia Beach city,518100404024,2014,49464,967,177,172,5
Virginia Beach city,518100404024,2015,46250,982,198,192,6
Virginia Beach city,518100404024,2016,0,763,210,202,8
Virginia Beach city,518100404024,2017,58796,979,136,130,6
Virginia Beach city,518100404024,2018,58152,1136,184,175,9
Virginia Beach city,518100404024,2019,65547,1186,79,2,77
Virginia Beach city,518100404031,2014,41094,840,82,13,69
Virginia Beach city,518100404031,2015,41929,834,22,0,22
Virginia Beach city,518100404031,2016,46345,784,33,0,33
Virginia Beach city,518100404031,2017,47241,926,27,0,27
Virginia Beach city,518100404031,2018,51585,1032,8,0,8
Virginia Beach city,518100404031,2019,53705,1129,110,75,35
Virginia Beach city,518100404031,2020,52630,890,209,155,54
Virginia Beach city,518100404031,2021,55441,942,248,168,80
Virginia Beach city,518100404032,2014,52375,1337,47,31,16
Virginia Beach city,518100404032,2015,63426,1525,43,9,34
Virginia Beach city,518100404032,2016,67893,1434,72,26,46
Virginia Beach city,518100404032,2017,68546,1445,68,30,38
Virginia Beach city,518100404032,2018,78958,1501,47,26,21
Virginia Beach city,518100404032,2019,74107,1314,56,31,25
Virginia Beach city,518100404032,2020,66979,1256,147,24,123
Virginia Beach city,518100404032,2021,72750,1356,0,0,0
Virginia Beach city,518100404033,2014,44190,1024,264,58,206
Virginia Beach city,518100404033,2015,43954,970,279,80,199
Virginia Beach city,518100404033,2016,43974,862,299,102,197
Virginia Beach city,518100404033,2017,43750,910,260,113,147
Virginia Beach city,518100404033,2018,44125,959,215,90,125
Virginia Beach city,518100404033,2019,43523,876,185,98,87
Virginia Beach city,518100404033,2020,64601,1144,120,32,88
Virginia Beach city,518100404033,2021,66622,1352,76,20,56
Virginia Beach city,518100404041,2014,92202,3858,272,98,174
Virginia Beach city,518100404041,2015,89538,3951,313,86,227
Virginia Beach city,518100404041,2016,95417,4173,283,33,250
Virginia Beach city,518100404041,2017,84063,3832,246,16,230
Virginia Beach city,518100404041,2018,87634,3794,192,0,192
Virginia Beach city,518100404041,2019,96029,3680,111,0,111
Virginia Beach city,518100404041,2020,76296,1724,136,136,0
Virginia Beach city,518100404041,2021,83587,1852,204,204,0
Virginia Beach city,518100404042,2014,99333,954,14,14,0
Virginia Beach city,518100404042,2015,99038,1045,11,11,0
Virginia Beach city,518100404042,2016,96518,1320,9,9,0
Virginia Beach city,518100404042,2017,98246,1323,10,10,0
Virginia Beach city,518100404042,2018,98715,1720,0,0,0
Virginia Beach city,518100404042,2019,94875,2291,0,0,0
Virginia Beach city,518100404042,2020,93000,2058,0,0,0
Virginia Beach city,518100404042,2021,99102,1936,0,0,0
Virginia Beach city,518100404043,2014,64194,584,35,0,35
Virginia Beach city,518100404043,2015,64350,576,0,0,0
Virginia Beach city,518100404043,2016,105625,513,0,0,0
Virginia Beach city,518100404043,2017,101845,661,92,92,0
Virginia Beach city,518100404043,2018,103684,705,93,93,0
Virginia Beach city,518100404043,2019,97130,786,108,108,0
Virginia Beach city,518100404043,2020,136713,1003,0,0,0
Virginia Beach city,518100404043,2021,118194,727,0,0,0
Virginia Beach city,518100404044,2014,80385,1045,0,0,0
Virginia Beach city,518100404044,2015,72292,933,0,0,0
Virginia Beach city,518100404044,2016,71635,708,0,0,0
Virginia Beach city,518100404044,2017,65000,520,0,0,0
Virginia Beach city,518100404044,2018,68778,856,16,16,0
Virginia Beach city,518100404044,2019,69677,961,23,23,0
Virginia Beach city,518100404044,2020,79706,1430,0,0,0
Virginia Beach city,518100404044,2021,104839,1869,0,0,0
Virginia Beach city,518100406001,2014,53668,1432,349,143,206
Virginia Beach city,518100406001,2015,59318,1860,304,63,241
Virginia Beach city,518100406001,2016,53526,2151,528,141,387
Virginia Beach city,518100406001,2017,47259,2316,629,250,379
Virginia Beach city,518100406001,2018,49597,2550,657,234,423
Virginia Beach city,518100406001,2019,54628,2541,623,170,453
Virginia Beach city,518100406001,2020,0,2988,685,176,509
Virginia Beach city,518100406001,2021,51932,2698,753,300,453
Virginia Beach city,518100406002,2014,44348,1469,824,311,513
Virginia Beach city,518100406002,2015,33063,1428,955,316,639
Virginia Beach city,518100406002,2016,44250,1436,724,42,682
Virginia Beach city,518100406002,2017,45625,1449,620,53,567
Virginia Beach city,518100406002,2018,39915,1679,398,77,321
Virginia Beach city,518100406002,2019,41123,1913,492,73,419
Virginia Beach city,518100406002,2020,59457,1701,348,348,0
Virginia Beach city,518100406002,2021,60833,1486,404,378,26
Virginia Beach city,518100406003,2014,60245,1678,356,174,182
Virginia Beach city,518100406003,2015,59500,1499,351,184,167
Virginia Beach city,518100406003,2016,63052,1381,262,134,128
Virginia Beach city,518100406003,2017,65761,1696,132,22,110
Virginia Beach city,518100406003,2018,50750,1424,79,27,52
Virginia Beach city,518100406003,2019,64250,1356,102,83,19
Virginia Beach city,518100406003,2020,63778,886,41,41,0
Virginia Beach city,518100406003,2021,66552,975,89,67,22
Virginia Beach city,518100408011,2014,47257,1166,65,65,0
Virginia Beach city,518100408011,2015,47193,1256,23,23,0
Virginia Beach city,518100408011,2016,48340,1301,6,0,6
Virginia Beach city,518100408011,2017,48885,1212,54,47,7
Virginia Beach city,518100408011,2018,43505,865,51,42,9
Virginia Beach city,518100408011,2019,43932,885,65,55,10
Virginia Beach city,518100408011,2020,46250,545,118,103,15
Virginia Beach city,518100408011,2021,55500,670,134,111,23
Virginia Beach city,518100408012,2014,45972,1181,102,78,24
Virginia Beach city,518100408012,2015,50556,1130,105,78,27
Virginia Beach city,518100408012,2016,44028,855,162,99,63
Virginia Beach city,518100408012,2017,61477,997,96,67,29
Virginia Beach city,518100408012,2018,63990,1239,71,43,28
Virginia Beach city,518100408012,2019,50921,965,37,8,29
Virginia Beach city,518100408012,2020,44669,792,69,9,60
Virginia Beach city,518100408012,2021,56250,1292,9,9,0
Virginia Beach city,518100408013,2014,45197,998,80,21,59
Virginia Beach city,518100408013,2015,64450,978,27,9,18
Virginia Beach city,518100408013,2016,68219,979,32,0,32
Virginia Beach city,518100408013,2017,67292,991,30,0,30
Virginia Beach city,518100408013,2018,77361,1063,29,0,29
Virginia Beach city,518100408013,2019,76974,1153,87,44,43
Virginia Beach city,518100408013,2020,76757,879,76,11,65
Virginia Beach city,518100408013,2021,81210,669,58,54,4
Virginia Beach city,518100408014,2014,56250,641,11,0,11
Virginia Beach city,518100408014,2015,60227,879,14,0,14
Virginia Beach city,518100408014,2016,62917,873,8,0,8
Virginia Beach city,518100408014,2017,61711,1033,32,23,9
Virginia Beach city,518100408014,2018,68021,968,11,11,0
Virginia Beach city,518100408014,2019,83409,907,20,20,0
Virginia Beach city,518100408014,2020,56023,976,192,57,135
Virginia Beach city,518100408014,2021,57934,926,192,41,151
Virginia Beach city,518100408021,2014,54032,606,31,0,31
Virginia Beach city,518100408021,2015,54276,594,39,14,25
Virginia Beach city,518100408021,2016,47368,535,34,12,22
Virginia Beach city,518100408021,2017,58073,510,33,8,25
Virginia Beach city,518100408021,2018,68646,465,7,7,0
Virginia Beach city,518100408021,2019,62000,427,9,9,0
Virginia Beach city,518100408021,2020,69583,514,0,0,0
Virginia Beach city,518100408021,2021,76481,489,0,0,0
Virginia Beach city,518100408022,2014,50625,799,33,33,0
Virginia Beach city,518100408022,2015,54013,813,8,0,8
Virginia Beach city,518100408022,2016,53984,937,8,0,8
Virginia Beach city,518100408022,2017,79444,1032,12,0,12
Virginia Beach city,518100408022,2018,67857,800,15,0,15
Virginia Beach city,518100408022,2019,65500,728,32,14,18
Virginia Beach city,518100408022,2020,61814,752,45,35,10
Virginia Beach city,518100408022,2021,68359,793,45,34,11
Virginia Beach city,518100408023,2014,60030,2066,309,146,163
Virginia Beach city,518100408023,2015,60889,2154,312,217,95
Virginia Beach city,518100408023,2016,64871,2169,311,218,93
Virginia Beach city,518100408023,2017,71250,2468,233,117,116
Virginia Beach city,518100408023,2018,78285,2775,202,79,123
Virginia Beach city,518100408023,2019,76625,2565,243,110,133
Virginia Beach city,518100408023,2020,79868,2601,170,53,117
Virginia Beach city,518100408023,2021,78250,2558,206,60,146
Virginia Beach city,518100408024,2014,65104,417,196,170,26
Virginia Beach city,518100408024,2015,78929,554,164,164,0
Virginia Beach city,518100408024,2016,97870,505,86,86,0
Virginia Beach city,518100408024,2017,91250,548,16,0,16
Virginia Beach city,518100408024,2018,101032,601,26,0,26
Virginia Beach city,518100408024,2019,103125,576,29,0,29
Virginia Beach city,518100408024,2020,60625,437,52,26,26
Virginia Beach city,518100408024,2021,64722,552,65,33,32
Virginia Beach city,518100410021,2014,53583,964,31,14,17
Virginia Beach city,518100410021,2015,55114,985,41,12,29
Virginia Beach city,518100410021,2016,53542,1232,60,10,50
Virginia Beach city,518100410021,2017,55587,1353,75,6,69
Virginia Beach city,518100410021,2018,56366,1355,62,0,62
Virginia Beach city,518100410021,2019,58220,1407,59,0,59
Virginia Beach city,518100410021,2020,46711,1676,51,0,51
Virginia Beach city,518100410021,2021,56146,1644,17,5,12
Virginia Beach city,518100410022,2014,39135,732,303,65,238
Virginia Beach city,518100410022,2015,42697,689,294,119,175
Virginia Beach city,518100410022,2016,40083,524,308,120,188
Virginia Beach city,518100410022,2017,37292,455,321,157,164
Virginia Beach city,518100410022,2018,37361,500,237,139,98
Virginia Beach city,518100410022,2019,37973,512,175,105,70
Virginia Beach city,518100410022,2020,38750,546,218,61,157
Virginia Beach city,518100410022,2021,41722,609,280,59,221
Virginia Beach city,518100410031,2014,53850,1014,115,23,92
Virginia Beach city,518100410031,2015,65851,968,95,20,75
Virginia Beach city,518100410031,2016,67500,1020,62,19,43
Virginia Beach city,518100410031,2017,68438,905,66,23,43
Virginia Beach city,518100410031,2018,73438,929,50,11,39
Virginia Beach city,518100410031,2019,84000,800,9,0,9
Virginia Beach city,518100410031,2020,89526,810,0,0,0
Virginia Beach city,518100410031,2021,96111,919,0,0,0
Virginia Beach city,518100410032,2014,60518,833,49,49,0
Virginia Beach city,518100410032,2015,49926,1066,90,90,0
Virginia Beach city,518100410032,2016,47647,1125,77,77,0
Virginia Beach city,518100410032,2017,49861,1142,67,59,8
Virginia Beach city,518100410032,2018,44046,1157,82,74,8
Virginia Beach city,518100410032,2019,40805,970,78,66,12
Virginia Beach city,518100410032,2020,45841,995,130,120,10
Virginia Beach city,518100410032,2021,48073,1013,185,170,15
Virginia Beach city,518100410033,2014,80230,840,41,18,23
Virginia Beach city,518100410033,2015,78393,698,83,0,83
Virginia Beach city,518100410033,2016,59375,654,51,0,51
Virginia Beach city,518100410033,2017,92933,790,63,0,63
Virginia Beach city,518100410033,2018,100000,682,110,10,100
Virginia Beach city,518100410033,2019,101625,778,96,14,82
Virginia Beach city,518100410033,2020,67115,959,53,11,42
Virginia Beach city,518100410033,2021,90167,798,49,10,39
Virginia Beach city,518100410034,2014,46500,452,13,0,13
Virginia Beach city,518100410034,2015,57738,550,16,0,16
Virginia Beach city,518100410034,2016,46750,482,18,0,18
Virginia Beach city,518100410034,2017,60144,427,26,26,0
Virginia Beach city,518100410034,2018,56250,470,23,23,0
Virginia Beach city,518100410034,2019,57847,567,41,30,11
Virginia Beach city,518100410034,2020,68667,637,50,22,28
Virginia Beach city,518100410034,2021,79432,626,59,24,35
Virginia Beach city,518100410041,2014,61993,775,10,10,0
Virginia Beach city,518100410041,2015,61587,768,0,0,0
Virginia Beach city,518100410041,2016,64010,752,28,22,6
Virginia Beach city,518100410041,2017,63750,734,32,16,16
Virginia Beach city,518100410041,2018,66801,736,95,20,75
Virginia Beach city,518100410041,2019,69395,776,105,26,79
Virginia Beach city,518100410041,2020,72969,572,135,58,77
Virginia Beach city,518100410041,2021,53409,556,91,0,91
Virginia Beach city,518100410042,2014,48500,705,113,90,23
Virginia Beach city,518100410042,2015,41406,466,123,116,7
Virginia Beach city,518100410042,2016,41611,555,142,136,6
Virginia Beach city,518100410042,2017,41972,506,197,174,23
Virginia Beach city,518100410042,2018,41544,431,173,137,36
Virginia Beach city,518100410042,2019,42530,389,70,31,39
Virginia Beach city,518100410042,2020,46968,462,44,9,35
Virginia Beach city,518100410042,2021,54167,216,68,28,40
Virginia Beach city,518100410043,2014,61500,1161,178,112,66
Virginia Beach city,518100410043,2015,60156,997,183,112,71
Virginia Beach city,518100410043,2016,53083,1000,252,171,81
Virginia Beach city,518100410043,2017,62212,1145,131,64,67
Virginia Beach city,518100410043,2018,65417,1087,161,84,77
Virginia Beach city,518100410043,2019,75298,1050,150,66,84
Virginia Beach city,518100410043,2020,71190,1030,155,111,44
Virginia Beach city,518100410043,2021,75833,1029,61,19,42
Virginia Beach city,518100410044,2014,52125,1116,167,66,101
Virginia Beach city,518100410044,2015,62216,1252,237,178,59
Virginia Beach city,518100410044,2016,62188,1107,229,180,49
Virginia Beach city,518100410044,2017,64018,1203,196,140,56
Virginia Beach city,518100410044,2018,72361,1310,236,192,44
Virginia Beach city,518100410044,2019,72039,1311,226,193,33
Virginia Beach city,518100410044,2020,72283,1355,84,69,15
Virginia Beach city,518100410044,2021,75438,1688,109,78,31
Virginia Beach city,518100412001,2014,90147,1421,0,0,0
Virginia Beach city,518100412001,2015,86500,1161,0,0,0
Virginia Beach city,518100412001,2016,87315,1015,29,0,29
Virginia Beach city,518100412001,2017,82788,1130,32,0,32
Virginia Beach city,518100412001,2018,92500,1053,47,0,47
Virginia Beach city,518100412001,2019,91146,1054,45,0,45
Virginia Beach city,518100412001,2020,77500,1009,50,0,50
Virginia Beach city,518100412001,2021,97839,1081,45,0,45
Virginia Beach city,518100412002,2014,66250,1877,42,42,0
Virginia Beach city,518100412002,2015,62941,2061,102,77,25
Virginia Beach city,518100412002,2016,71413,2244,124,91,33
Virginia Beach city,518100412002,2017,73971,2181,190,134,56
Virginia Beach city,518100412002,2018,54806,2158,269,162,107
Virginia Beach city,518100412002,2019,61125,2355,304,167,137
Virginia Beach city,518100412002,2020,70754,2096,210,79,131
Virginia Beach city,518100412002,2021,73647,2252,233,115,118
Virginia Beach city,518100412003,2014,83631,1517,73,37,36
Virginia Beach city,518100412003,2015,80945,1241,70,41,29
Virginia Beach city,518100412003,2016,84289,1144,70,42,28
Virginia Beach city,518100412003,2017,95699,1383,32,32,0
Virginia Beach city,518100412003,2018,88929,1338,85,16,69
Virginia Beach city,518100412003,2019,57109,1173,89,16,73
Virginia Beach city,518100412003,2020,57259,1209,71,3,68
Virginia Beach city,518100412003,2021,59714,1446,119,46,73
Virginia Beach city,518100412004,2014,83767,1029,0,0,0
Virginia Beach city,518100412004,2015,74934,988,0,0,0
Virginia Beach city,518100412004,2016,83350,1026,0,0,0
Virginia Beach city,518100412004,2017,79412,1076,0,0,0
Virginia Beach city,518100412004,2018,81622,1077,0,0,0
Virginia Beach city,518100412004,2019,83375,960,0,0,0
Virginia Beach city,518100412004,2020,110159,829,0,0,0
Virginia Beach city,518100412004,2021,173571,716,0,0,0
Virginia Beach city,518100414001,2014,140781,1772,27,27,0
Virginia Beach city,518100414001,2015,142500,1827,26,26,0
Virginia Beach city,518100414001,2016,137386,2142,9,9,0
Virginia Beach city,518100414001,2017,147143,2160,21,21,0
Virginia Beach city,518100414001,2018,140417,2266,15,15,0
Virginia Beach city,518100414001,2019,165301,2166,15,15,0
Virginia Beach city,518100414001,2020,136563,2333,30,30,0
Virginia Beach city,518100414001,2021,177500,2253,33,33,0
Virginia Beach city,518100414002,2014,71445,1683,145,33,112
Virginia Beach city,518100414002,2015,85139,1711,57,34,23
Virginia Beach city,518100414002,2016,78158,1703,63,47,16
Virginia Beach city,518100414002,2017,74948,1550,68,51,17
Virginia Beach city,518100414002,2018,96071,1534,66,41,25
Virginia Beach city,518100414002,2019,108824,1548,52,43,9
Virginia Beach city,518100414002,2020,117350,1332,50,41,9
Virginia Beach city,518100414002,2021,128125,1500,41,34,7
Virginia Beach city,518100414003,2014,85417,1508,35,35,0
Virginia Beach city,518100414003,2015,77813,1560,38,38,0
Virginia Beach city,518100414003,2016,82188,1557,39,39,0
Virginia Beach city,518100414003,2017,91528,1575,43,43,0
Virginia Beach city,518100414003,2018,91250,1448,82,54,28
Virginia Beach city,518100414003,2019,95417,1643,38,8,30
Virginia Beach city,518100414003,2020,148889,1485,39,9,30
Virginia Beach city,518100414003,2021,126250,1216,53,9,44
Virginia Beach city,518100416001,2014,64150,855,38,17,21
Virginia Beach city,518100416001,2015,72938,904,33,22,11
Virginia Beach city,518100416001,2016,71500,915,12,12,0
Virginia Beach city,518100416001,2017,81897,1039,11,11,0
Virginia Beach city,518100416001,2018,89111,1224,12,12,0
Virginia Beach city,518100416001,2019,91036,1144,0,0,0
Virginia Beach city,518100416001,2020,109279,1179,0,0,0
Virginia Beach city,518100416001,2021,135625,1056,0,0,0
Virginia Beach city,518100416002,2014,55000,832,31,1,30
Virginia Beach city,518100416002,2015,56650,855,5,2,3
Virginia Beach city,518100416002,2016,79583,850,4,1,3
Virginia Beach city,518100416002,2017,78816,780,3,1,2
Virginia Beach city,518100416002,2018,86359,598,6,2,4
Virginia Beach city,518100416002,2019,79856,717,4,3,1
Virginia Beach city,518100416002,2020,75197,737,4,2,2
Virginia Beach city,518100416002,2021,69167,849,21,18,3
Virginia Beach city,518100416003,2014,58875,980,30,12,18
Virginia Beach city,518100416003,2015,69750,856,18,0,18
Virginia Beach city,518100416003,2016,82778,1080,22,7,15
Virginia Beach city,518100416003,2017,80561,998,8,8,0
Virginia Beach city,518100416003,2018,82902,1095,17,17,0
Virginia Beach city,518100416003,2019,74775,986,15,15,0
Virginia Beach city,518100416003,2020,74722,815,13,13,0
Virginia Beach city,518100416003,2021,65926,734,19,19,0
Virginia Beach city,518100416004,2014,121875,631,7,7,0
Virginia Beach city,518100416004,2015,100000,680,11,11,0
Virginia Beach city,518100416004,2016,82143,546,29,29,0
Virginia Beach city,518100416004,2017,91875,579,25,25,0
Virginia Beach city,518100416004,2018,103235,544,20,20,0
Virginia Beach city,518100416004,2019,118429,584,20,20,0
Virginia Beach city,518100416004,2020,112375,513,19,19,0
Virginia Beach city,518100416004,2021,126250,702,9,9,0
Virginia Beach city,518100418011,2014,83992,1334,185,20,165
Virginia Beach city,518100418011,2015,103571,1383,60,7,53
Virginia Beach city,518100418011,2016,114167,1612,58,5,53
Virginia Beach city,518100418011,2017,120714,1840,44,0,44
Virginia Beach city,518100418011,2018,87589,1725,47,0,47
Virginia Beach city,518100418011,2019,114872,1593,0,0,0
Virginia Beach city,518100418011,2020,70493,2666,191,191,0
Virginia Beach city,518100418011,2021,74081,2280,357,273,84
Virginia Beach city,518100418012,2014,42428,1817,335,96,239
Virginia Beach city,518100418012,2015,43288,1902,192,100,92
Virginia Beach city,518100418012,2016,42896,1858,288,173,115
Virginia Beach city,518100418012,2017,44719,1546,306,219,87
Virginia Beach city,518100418012,2018,44531,1307,390,338,52
Virginia Beach city,518100418012,2019,45531,1517,417,399,18
Virginia Beach city,518100418012,2020,65909,1029,0,0,0
Virginia Beach city,518100418012,2021,57688,761,0,0,0
Virginia Beach city,518100418013,2014,45469,984,378,378,0
Virginia Beach city,518100418013,2015,55536,1331,290,262,28
Virginia Beach city,518100418013,2016,61964,1452,140,113,27
Virginia Beach city,518100418013,2017,66250,1329,7,0,7
Virginia Beach city,518100418013,2018,65469,930,25,0,25
Virginia Beach city,518100418013,2019,66000,1024,28,0,28
Virginia Beach city,518100418013,2020,50858,799,264,142,122
Virginia Beach city,518100418013,2021,56429,1018,171,72,99
Virginia Beach city,518100418021,2014,92917,2059,12,0,12
Virginia Beach city,518100418021,2015,92037,1921,68,48,20
Virginia Beach city,518100418021,2016,102941,1844,74,52,22
Virginia Beach city,518100418021,2017,108708,1812,77,57,20
Virginia Beach city,518100418021,2018,112793,1794,97,70,27
Virginia Beach city,518100418021,2019,106250,1533,104,91,13
Virginia Beach city,518100418022,2014,75486,725,54,32,22
Virginia Beach city,518100418022,2015,75893,773,130,66,64
Virginia Beach city,518100418022,2016,91458,745,176,95,81
Virginia Beach city,518100418022,2017,99091,833,175,115,60
Virginia Beach city,518100418022,2018,102794,981,146,100,46
Virginia Beach city,518100418022,2019,114659,1030,134,63,71
Virginia Beach city,518100418023,2014,62109,598,43,14,29
Virginia Beach city,518100418023,2015,68654,486,39,15,24
Virginia Beach city,518100418023,2016,56630,738,61,16,45
Virginia Beach city,518100418023,2017,56675,734,42,19,23
Virginia Beach city,518100418023,2018,59583,506,29,18,11
Virginia Beach city,518100418023,2019,63359,538,17,0,17
Virginia Beach city,518100418024,2014,63102,1898,69,19,50
Virginia Beach city,518100418024,2015,70425,1962,85,19,66
Virginia Beach city,518100418024,2016,74727,1959,72,0,72
Virginia Beach city,518100418024,2017,74174,1888,100,28,72
Virginia Beach city,518100418024,2018,79833,1855,87,41,46
Virginia Beach city,518100418024,2019,85833,1723,83,44,39
Virginia Beach city,518100420001,2014,166852,1241,15,5,10
Virginia Beach city,518100420001,2015,166484,1086,19,9,10
Virginia Beach city,518100420001,2016,168056,1208,17,7,10
Virginia Beach city,518100420001,2017,155357,1333,32,22,10
Virginia Beach city,518100420001,2018,159737,1216,49,21,28
Virginia Beach city,518100420001,2019,161625,1279,46,17,29
Virginia Beach city,518100420001,2020,164813,1333,44,15,29
Virginia Beach city,518100420001,2021,159028,1387,42,15,27
Virginia Beach city,518100420002,2014,176382,1258,20,20,0
Virginia Beach city,518100420002,2015,165500,1493,19,19,0
Virginia Beach city,518100420002,2016,159556,1398,20,20,0
Virginia Beach city,518100420002,2017,155865,1198,20,20,0
Virginia Beach city,518100420002,2018,162917,1307,0,0,0
Virginia Beach city,518100420002,2019,170521,1175,10,10,0
Virginia Beach city,518100420002,2020,134196,974,10,10,0
Virginia Beach city,518100420002,2021,138661,1044,10,10,0
Virginia Beach city,518100420003,2014,156250,875,29,29,0
Virginia Beach city,518100420003,2015,182917,805,27,27,0
Virginia Beach city,518100420003,2016,159766,797,27,27,0
Virginia Beach city,518100420003,2017,149485,792,27,27,0
Virginia Beach city,518100420003,2018,158750,867,0,0,0
Virginia Beach city,518100420003,2019,162212,963,0,0,0
Virginia Beach city,518100420003,2020,189167,1107,0,0,0
Virginia Beach city,518100420003,2021,243083,1347,0,0,0
Virginia Beach city,518100422011,2014,84219,1244,40,40,0
Virginia Beach city,518100422011,2015,71188,1294,0,0,0
Virginia Beach city,518100422011,2016,74300,1273,10,0,10
Virginia Beach city,518100422011,2017,77321,1232,9,0,9
Virginia Beach city,518100422011,2018,79211,1145,20,11,9
Virginia Beach city,518100422011,2019,79167,1221,29,20,9
Virginia Beach city,518100422011,2020,83125,1043,44,35,9
Virginia Beach city,518100422011,2021,84896,1151,37,37,0
Virginia Beach city,518100422012,2014,92692,1545,83,0,83
Virginia Beach city,518100422012,2015,93869,1596,75,0,75
Virginia Beach city,518100422012,2016,91750,1559,36,0,36
Virginia Beach city,518100422012,2017,94583,1679,35,35,0
Virginia Beach city,518100422012,2018,106350,1799,38,38,0
Virginia Beach city,518100422012,2019,102143,1871,55,55,0
Virginia Beach city,518100422012,2020,90938,1729,56,56,0
Virginia Beach city,518100422012,2021,109375,1771,55,55,0
Virginia Beach city,518100422013,2014,144615,622,9,9,0
Virginia Beach city,518100422013,2015,148750,650,9,9,0
Virginia Beach city,518100422013,2016,142614,639,9,9,0
Virginia Beach city,518100422013,2017,144271,658,8,8,0
Virginia Beach city,518100422013,2018,167614,668,8,8,0
Virginia Beach city,518100422013,2019,174125,477,0,0,0
Virginia Beach city,518100422013,2020,175536,345,0,0,0
Virginia Beach city,518100422013,2021,183214,363,0,0,0
Virginia Beach city,518100422021,2014,149816,1321,14,14,0
Virginia Beach city,518100422021,2015,163625,1235,11,11,0
Virginia Beach city,518100422021,2016,150250,1039,12,12,0
Virginia Beach city,518100422021,2017,139583,901,15,15,0
Virginia Beach city,518100422021,2018,137031,827,23,23,0
Virginia Beach city,518100422021,2019,141806,786,0,0,0
Virginia Beach city,518100422021,2020,138125,729,0,0,0
Virginia Beach city,518100422021,2021,176875,992,0,0,0
Virginia Beach city,518100422022,2014,76563,1904,84,84,0
Virginia Beach city,518100422022,2015,76364,1834,95,78,17
Virginia Beach city,518100422022,2016,79464,2027,98,76,22
Virginia Beach city,518100422022,2017,81726,2197,82,53,29
Virginia Beach city,518100422022,2018,86875,1845,89,57,32
Virginia Beach city,518100422022,2019,89271,1791,48,16,32
Virginia Beach city,518100422022,2020,106452,2196,38,16,22
Virginia Beach city,518100422022,2021,98693,1517,36,17,19
Virginia Beach city,518100422023,2014,55000,579,13,10,3
Virginia Beach city,518100422023,2015,68500,630,14,9,5
Virginia Beach city,518100422023,2016,69879,652,57,30,27
Virginia Beach city,518100422023,2017,73043,711,50,29,21
Virginia Beach city,518100422023,2018,89125,680,48,27,21
Virginia Beach city,518100422023,2019,80375,719,49,31,18
Virginia Beach city,518100422023,2020,78182,585,47,28,19
Virginia Beach city,518100422023,2021,86597,693,20,17,3
Virginia Beach city,518100422024,2014,66429,684,68,0,68
Virginia Beach city,518100422024,2015,54464,675,62,0,62
Virginia Beach city,518100422024,2016,56250,659,20,0,20
Virginia Beach city,518100422024,2017,60703,642,19,0,19
Virginia Beach city,518100422024,2018,59688,819,17,0,17
Virginia Beach city,518100422024,2019,72375,805,55,0,55
Virginia Beach city,518100422024,2020,100909,762,49,0,49
Virginia Beach city,518100422024,2021,93500,828,35,0,35
Virginia Beach city,518100424001,2014,70921,1017,51,41,10
Virginia Beach city,518100424001,2015,70956,886,59,49,10
Virginia Beach city,518100424001,2016,81500,1011,50,39,11
Virginia Beach city,518100424001,2017,74135,768,91,36,55
Virginia Beach city,518100424001,2018,74722,809,88,50,38
Virginia Beach city,518100424001,2019,64722,730,108,57,51
Virginia Beach city,518100424001,2020,65000,527,106,53,53
Virginia Beach city,518100424001,2021,89844,665,96,48,48
Virginia Beach city,518100424002,2014,64500,1089,130,65,65
Virginia Beach city,518100424002,2015,59766,1201,111,47,64
Virginia Beach city,518100424002,2016,54926,1314,131,49,82
Virginia Beach city,518100424002,2017,35648,1232,143,31,112
Virginia Beach city,518100424002,2018,45313,1299,107,10,97
Virginia Beach city,518100424002,2019,39261,1123,121,16,105
Virginia Beach city,518100424002,2020,48065,804,91,0,91
Virginia Beach city,518100424002,2021,51048,762,148,26,122
Virginia Beach city,518100424003,2014,46806,828,195,72,123
Virginia Beach city,518100424003,2015,55208,906,95,0,95
Virginia Beach city,518100424003,2016,60625,934,0,0,0
Virginia Beach city,518100424003,2017,46838,1068,0,0,0
Virginia Beach city,518100424003,2018,61685,1031,42,0,42
Virginia Beach city,518100424003,2019,77841,1185,94,0,94
Virginia Beach city,518100424003,2020,64302,1086,115,35,80
Virginia Beach city,518100424003,2021,80476,1326,135,53,82
Virginia Beach city,518100424004,2014,75313,1429,79,53,26
Virginia Beach city,518100424004,2015,73813,1693,112,89,23
Virginia Beach city,518100424004,2016,71534,1615,106,78,28
Virginia Beach city,518100424004,2017,77292,1537,101,77,24
Virginia Beach city,518100424004,2018,89231,1337,52,44,8
Virginia Beach city,518100424004,2019,93438,1175,54,49,5
Virginia Beach city,518100424004,2020,80921,939,7,0,7
Virginia Beach city,518100424004,2021,85469,860,22,0,22
Virginia Beach city,518100426001,2014,72788,1169,91,25,66
Virginia Beach city,518100426001,2016,70469,1190,90,26,64
Virginia Beach city,518100426001,2017,91250,1241,82,22,60
Virginia Beach city,518100426001,2018,103750,1137,94,46,48
Virginia Beach city,518100426001,2019,113452,1018,51,45,6
Virginia Beach city,518100426001,2020,113036,1092,42,34,8
Virginia Beach city,518100426002,2014,45750,1088,115,90,25
Virginia Beach city,518100426002,2015,46862,1072,216,63,153
Virginia Beach city,518100426002,2016,48171,988,235,97,138
Virginia Beach city,518100426002,2017,51917,1051,247,84,163
Virginia Beach city,518100426002,2018,63086,1355,264,10,254
Virginia Beach city,518100426002,2019,64679,1475,282,9,273
Virginia Beach city,518100426002,2020,56332,1045,80,41,39
Virginia Beach city,518100426002,2021,58203,1108,68,23,45
Virginia Beach city,518100428011,2014,76133,1598,101,61,40
Virginia Beach city,518100428011,2015,75476,1515,100,62,38
Virginia Beach city,518100428011,2016,62875,1627,111,63,48
Virginia Beach city,518100428011,2017,70286,1418,291,126,165
Virginia Beach city,518100428011,2018,65521,994,173,73,100
Virginia Beach city,518100428011,2019,63906,1389,221,108,113
Virginia Beach city,518100428011,2020,66982,2009,259,97,162
Virginia Beach city,518100428011,2021,75000,1325,235,84,151
Virginia Beach city,518100428012,2014,62727,1005,26,0,26
Virginia Beach city,518100428012,2015,52031,791,81,0,81
Virginia Beach city,518100428012,2016,65441,649,71,0,71
Virginia Beach city,518100428012,2017,62857,787,60,0,60
Virginia Beach city,518100428012,2018,73365,920,50,0,50
Virginia Beach city,518100428012,2019,67188,657,22,0,22
Virginia Beach city,518100428012,2020,59327,552,0,0,0
Virginia Beach city,518100428012,2021,60045,615,0,0,0
Virginia Beach city,518100428013,2014,67212,1093,63,44,19
Virginia Beach city,518100428013,2015,85161,1016,58,42,16
Virginia Beach city,518100428013,2016,81944,1125,44,25,19
Virginia Beach city,518100428013,2017,81146,1127,25,25,0
Virginia Beach city,518100428013,2018,79559,1020,45,45,0
Virginia Beach city,518100428013,2019,80833,1163,28,20,8
Virginia Beach city,518100428013,2020,71071,899,59,54,5
Virginia Beach city,518100428013,2021,50809,804,396,92,304
Virginia Beach city,518100428014,2014,64076,815,49,17,32
Virginia Beach city,518100428014,2015,68472,1012,55,18,37
Virginia Beach city,518100428014,2016,72014,965,49,17,32
Virginia Beach city,518100428014,2017,103938,1036,40,6,34
Virginia Beach city,518100428014,2018,105149,1120,48,6,42
Virginia Beach city,518100428014,2019,99205,1399,7,0,7
Virginia Beach city,518100428014,2020,91333,751,7,0,7
Virginia Beach city,518100428014,2021,94712,787,9,0,9
Virginia Beach city,518100428015,2014,70809,1298,111,0,111
Virginia Beach city,518100428015,2015,60556,1423,59,0,59
Virginia Beach city,518100428015,2016,64250,1374,62,10,52
Virginia Beach city,518100428015,2017,71719,1478,53,14,39
Virginia Beach city,518100428015,2018,57083,1413,8,8,0
Virginia Beach city,518100428015,2019,57188,1008,4,4,0
Virginia Beach city,518100428015,2020,73009,1482,8,8,0
Virginia Beach city,518100428015,2021,54115,1108,91,25,66
Virginia Beach city,518100428021,2014,47651,1756,149,14,135
Virginia Beach city,518100428021,2015,48438,1719,180,51,129
Virginia Beach city,518100428021,2016,46170,1825,191,61,130
Virginia Beach city,518100428021,2017,46925,1589,137,58,79
Virginia Beach city,518100428021,2018,53241,1487,148,82,66
Virginia Beach city,518100428021,2019,49909,1294,182,121,61
Virginia Beach city,518100428021,2020,51726,1409,130,44,86
Virginia Beach city,518100428021,2021,54150,1350,276,28,248
Virginia Beach city,518100428022,2014,50225,1611,125,72,53
Virginia Beach city,518100428022,2015,47415,1778,135,81,54
Virginia Beach city,518100428022,2016,49732,1849,180,141,39
Virginia Beach city,518100428022,2017,49556,2002,146,99,47
Virginia Beach city,518100428022,2018,48517,2087,156,106,50
Virginia Beach city,518100428022,2019,47321,1958,171,110,61
Virginia Beach city,518100428022,2020,46200,1604,134,79,55
Virginia Beach city,518100428022,2021,47468,1660,132,74,58
Virginia Beach city,518100428023,2014,71063,796,193,7,186
Virginia Beach city,518100428023,2015,83056,653,79,6,73
Virginia Beach city,518100428023,2016,48542,628,94,8,86
Virginia Beach city,518100428023,2017,0,718,90,0,90
Virginia Beach city,518100428023,2018,96250,843,0,0,0
Virginia Beach city,518100428023,2019,88625,842,12,12,0
Virginia Beach city,518100428023,2020,100625,777,14,14,0
Virginia Beach city,518100428023,2021,112639,763,23,23,0
Virginia Beach city,518100430021,2014,109076,1938,60,47,13
Virginia Beach city,518100430021,2015,125938,2075,52,39,13
Virginia Beach city,518100430021,2016,131838,2200,33,33,0
Virginia Beach city,518100430021,2017,132243,2088,71,31,40
Virginia Beach city,518100430021,2018,134452,2226,55,27,28
Virginia Beach city,518100430021,2019,136985,2320,48,21,27
Virginia Beach city,518100430021,2020,138456,2103,59,24,35
Virginia Beach city,518100430021,2021,144904,2003,36,0,36
Virginia Beach city,518100430022,2014,174423,2168,11,11,0
Virginia Beach city,518100430022,2015,179750,2058,7,7,0
Virginia Beach city,518100430022,2016,176625,1899,23,15,8
Virginia Beach city,518100430022,2017,155833,1880,24,15,9
Virginia Beach city,518100430022,2018,157750,1786,19,11,8
Virginia Beach city,518100430022,2019,150156,1679,17,11,6
Virginia Beach city,518100430022,2020,147917,1352,28,24,4
Virginia Beach city,518100430022,2021,160385,1754,88,9,79
Virginia Beach city,518100430031,2014,98240,1346,0,0,0
Virginia Beach city,518100430031,2015,91696,1565,0,0,0
Virginia Beach city,518100430031,2016,89666,1362,0,0,0
Virginia Beach city,518100430031,2017,93429,1038,23,23,0
Virginia Beach city,518100430031,2018,92679,1167,21,21,0
Virginia Beach city,518100430031,2019,83879,1302,23,23,0
Virginia Beach city,518100430032,2014,53438,1976,141,30,111
Virginia Beach city,518100430032,2015,73571,1998,132,16,116
Virginia Beach city,518100430032,2016,70000,2267,119,18,101
Virginia Beach city,518100430032,2017,71833,2316,100,16,84
Virginia Beach city,518100430032,2018,74851,2351,35,20,15
Virginia Beach city,518100430032,2019,73125,2201,41,23,18
Virginia Beach city,518100430033,2014,86146,968,14,14,0
Virginia Beach city,518100430033,2015,78250,935,0,0,0
Virginia Beach city,518100430033,2016,72759,957,56,56,0
Virginia Beach city,518100430033,2017,85190,1248,77,77,0
Virginia Beach city,518100430033,2018,83897,1343,76,64,12
Virginia Beach city,518100430033,2019,82276,1364,78,66,12
Virginia Beach city,518100430041,2014,82222,2260,74,31,43
Virginia Beach city,518100430041,2015,64688,2210,78,36,42
Virginia Beach city,518100430041,2016,78882,2676,67,28,39
Virginia Beach city,518100430041,2017,79878,2527,88,46,42
Virginia Beach city,518100430041,2018,79701,2585,62,44,18
Virginia Beach city,518100430041,2019,76842,2352,71,27,44
Virginia Beach city,518100430041,2020,91094,1219,8,8,0
Virginia Beach city,518100430041,2021,97083,1262,33,23,10
Virginia Beach city,518100430042,2014,71563,1528,157,127,30
Virginia Beach city,518100430042,2015,90083,1533,142,131,11
Virginia Beach city,518100430042,2016,79534,1311,35,24,11
Virginia Beach city,518100430042,2017,80921,1171,19,19,0
Virginia Beach city,518100430042,2018,82313,1161,0,0,0
Virginia Beach city,518100430042,2019,101078,1140,6,6,0
Virginia Beach city,518100430042,2020,66020,1210,86,51,35
Virginia Beach city,518100430042,2021,81250,1291,107,65,42
Virginia Beach city,518100432001,2014,51607,1025,96,29,67
Virginia Beach city,518100432001,2015,47019,898,111,30,81
Virginia Beach city,518100432001,2016,47250,874,57,0,57
Virginia Beach city,518100432001,2017,52083,1087,54,0,54
Virginia Beach city,518100432001,2018,62868,991,98,0,98
Virginia Beach city,518100432001,2019,61406,1054,125,12,113
Virginia Beach city,518100432001,2020,51500,1050,69,11,58
Virginia Beach city,518100432001,2021,51927,1107,66,12,54
Virginia Beach city,518100434001,2014,97614,731,0,0,0
Virginia Beach city,518100434001,2015,93929,578,0,0,0
Virginia Beach city,518100434001,2016,79728,538,0,0,0
Virginia Beach city,518100434001,2017,88583,555,9,9,0
Virginia Beach city,518100434001,2018,99167,673,9,9,0
Virginia Beach city,518100434001,2019,120938,750,10,10,0
Virginia Beach city,518100434001,2020,94167,811,10,10,0
Virginia Beach city,518100434001,2021,139464,820,14,14,0
Virginia Beach city,518100434002,2014,101932,1100,19,0,19
Virginia Beach city,518100434002,2015,104022,1065,0,0,0
Virginia Beach city,518100434002,2016,106894,1368,0,0,0
Virginia Beach city,518100434002,2017,113295,1413,24,24,0
Virginia Beach city,518100434002,2018,115882,1322,36,28,8
Virginia Beach city,518100434002,2019,113000,1427,55,40,15
Virginia Beach city,518100434002,2020,116944,1402,58,43,15
Virginia Beach city,518100434002,2021,118182,1368,75,57,18
Virginia Beach city,518100436001,2014,79148,746,64,29,35
Virginia Beach city,518100436001,2015,81667,662,50,30,20
Virginia Beach city,518100436001,2016,82344,658,52,29,23
Virginia Beach city,518100436001,2017,84861,709,54,43,11
Virginia Beach city,518100436001,2018,101250,722,37,26,11
Virginia Beach city,518100436001,2019,103750,798,39,32,7
Virginia Beach city,518100436001,2020,130250,829,33,27,6
Virginia Beach city,518100436001,2021,135521,739,25,25,0
Virginia Beach city,518100436002,2014,160500,853,0,0,0
Virginia Beach city,518100436002,2015,161875,889,23,5,18
Virginia Beach city,518100436002,2016,171250,877,45,24,21
Virginia Beach city,518100436002,2017,187619,967,47,23,24
Virginia Beach city,518100436002,2018,195000,922,49,21,28
Virginia Beach city,518100436002,2019,197880,875,85,26,59
Virginia Beach city,518100436002,2020,179859,1110,65,56,9
Virginia Beach city,518100436002,2021,204000,1091,85,49,36
Virginia Beach city,518100438001,2014,49441,483,29,6,23
Virginia Beach city,518100438001,2015,42679,627,38,7,31
Virginia Beach city,518100438001,2016,53864,780,36,6,30
Virginia Beach city,518100438001,2017,55804,738,21,6,15
Virginia Beach city,518100438001,2018,66250,750,14,7,7
Virginia Beach city,518100438001,2019,51111,825,10,0,10
Virginia Beach city,518100438001,2020,77014,762,0,0,0
Virginia Beach city,518100438001,2021,56705,761,12,12,0
Virginia Beach city,518100438002,2014,156750,747,15,8,7
Virginia Beach city,518100438002,2015,155125,845,15,8,7
Virginia Beach city,518100438002,2016,150694,753,11,11,0
Virginia Beach city,518100438002,2017,153750,900,0,0,0
Virginia Beach city,518100438002,2018,152125,1019,15,0,15
Virginia Beach city,518100438002,2019,176875,994,13,0,13
Virginia Beach city,518100438002,2020,152045,886,14,0,14
Virginia Beach city,518100438002,2021,114219,869,22,12,10
Virginia Beach city,518100438003,2014,49844,904,48,28,20
Virginia Beach city,518100438003,2015,65208,906,38,16,22
Virginia Beach city,518100438003,2016,65703,994,95,44,51
Virginia Beach city,518100438003,2017,80156,1002,117,59,58
Virginia Beach city,518100438003,2018,84519,1022,96,59,37
Virginia Beach city,518100438003,2019,86829,1022,99,65,34
Virginia Beach city,518100438003,2020,89777,1055,90,61,29
Virginia Beach city,518100438003,2021,108333,1059,31,31,0
Virginia Beach city,518100438004,2014,138849,1409,152,131,21
Virginia Beach city,518100438004,2015,171354,1309,36,16,20
Virginia Beach city,518100438004,2016,172763,1183,40,0,40
Virginia Beach city,518100438004,2017,178696,1188,43,0,43
Virginia Beach city,518100438004,2018,188261,1040,32,0,32
Virginia Beach city,518100438004,2019,185924,1034,22,0,22
Virginia Beach city,518100438004,2020,179271,1212,23,0,23
Virginia Beach city,518100438004,2021,220625,1378,20,10,10
Virginia Beach city,518100440011,2014,50254,1266,104,0,104
Virginia Beach city,518100440011,2015,50318,1350,99,0,99
Virginia Beach city,518100440011,2016,57841,1283,7,0,7
Virginia Beach city,518100440011,2017,53690,1156,50,30,20
Virginia Beach city,518100440011,2018,53923,955,76,39,37
Virginia Beach city,518100440011,2019,74886,1137,70,40,30
Virginia Beach city,518100440012,2014,51974,2032,108,86,22
Virginia Beach city,518100440012,2015,56724,1967,70,51,19
Virginia Beach city,518100440012,2016,55465,2099,137,79,58
Virginia Beach city,518100440012,2017,60061,2053,118,64,54
Virginia Beach city,518100440012,2018,57516,1866,135,81,54
Virginia Beach city,518100440012,2019,49853,1877,133,91,42
Virginia Beach city,518100440013,2014,59779,1371,73,16,57
Virginia Beach city,518100440013,2015,62500,1508,69,0,69
Virginia Beach city,518100440013,2016,58899,1437,11,11,0
Virginia Beach city,518100440013,2017,50950,1484,11,11,0
Virginia Beach city,518100440013,2018,39877,1233,58,58,0
Virginia Beach city,518100440013,2019,42109,784,75,75,0
Virginia Beach city,518100440014,2014,49550,1050,14,0,14
Virginia Beach city,518100440014,2015,46638,1095,15,0,15
Virginia Beach city,518100440014,2016,48047,1041,15,0,15
Virginia Beach city,518100440014,2017,47674,1095,225,225,0
Virginia Beach city,518100440014,2018,49896,1141,222,222,0
Virginia Beach city,518100440014,2019,48942,1316,250,250,0
Virginia Beach city,518100440031,2014,66250,998,93,79,14
Virginia Beach city,518100440031,2016,29394,585,51,22,29
Virginia Beach city,518100440031,2017,40515,489,41,25,16
Virginia Beach city,518100440031,2018,77870,433,76,62,14
Virginia Beach city,518100440031,2019,80293,469,83,70,13
Virginia Beach city,518100440032,2014,132891,1186,0,0,0
Virginia Beach city,518100440032,2015,100625,1118,14,14,0
Virginia Beach city,518100440032,2016,104911,1383,14,14,0
Virginia Beach city,518100440032,2017,104000,1419,55,55,0
Virginia Beach city,518100440032,2018,107083,1324,54,54,0
Virginia Beach city,518100440032,2019,105938,1309,76,76,0
Virginia Beach city,518100440033,2014,106618,1526,136,122,14
Virginia Beach city,518100440033,2015,92471,1423,115,105,10
Virginia Beach city,518100440033,2016,113021,1520,107,95,12
Virginia Beach city,518100440033,2017,120096,1579,104,92,12
Virginia Beach city,518100440033,2018,124000,1716,95,42,53
Virginia Beach city,518100440033,2019,130250,1436,107,36,71
Virginia Beach city,518100440034,2014,63594,739,69,41,28
Virginia Beach city,518100440034,2015,62805,884,84,47,37
Virginia Beach city,518100440034,2016,61161,664,87,48,39
Virginia Beach city,518100440034,2017,54103,736,103,61,42
Virginia Beach city,518100440034,2018,58061,838,55,15,40
Virginia Beach city,518100440034,2019,70396,1026,25,13,12
Virginia Beach city,518100440035,2014,54000,656,43,43,0
Virginia Beach city,518100440035,2015,60417,756,55,44,11
Virginia Beach city,518100440035,2016,54395,758,99,41,58
Virginia Beach city,518100440035,2017,67734,760,59,0,59
Virginia Beach city,518100440035,2018,81471,785,53,0,53
Virginia Beach city,518100440035,2019,89423,892,75,21,54
Virginia Beach city,518100440041,2014,59485,1363,196,151,45
Virginia Beach city,518100440041,2015,50536,1213,368,327,41
Virginia Beach city,518100440041,2016,32105,954,277,225,52
Virginia Beach city,518100440041,2017,33849,1001,227,170,57
Virginia Beach city,518100440041,2018,33828,867,283,162,121
Virginia Beach city,518100440041,2019,50977,911,221,119,102
Virginia Beach city,518100440041,2020,60063,809,357,294,63
Virginia Beach city,518100440041,2021,63284,803,302,267,35
Virginia Beach city,518100440042,2014,55402,704,28,23,5
Virginia Beach city,518100440042,2015,48036,742,45,36,9
Virginia Beach city,518100440042,2016,41875,887,108,43,65
Virginia Beach city,518100440042,2017,46184,801,101,49,52
Virginia Beach city,518100440042,2018,50556,755,89,45,44
Virginia Beach city,518100440042,2019,67206,826,73,44,29
Virginia Beach city,518100440042,2020,40729,415,209,152,57
Virginia Beach city,518100440042,2021,53365,457,256,154,102
Virginia Beach city,518100442001,2014,51833,1518,243,134,109
Virginia Beach city,518100442001,2015,54598,1659,277,164,113
Virginia Beach city,518100442001,2016,52599,1630,277,171,106
Virginia Beach city,518100442001,2017,54732,1404,382,269,113
Virginia Beach city,518100442001,2018,60909,1359,235,165,70
Virginia Beach city,518100442001,2019,81765,1506,176,141,35
Virginia Beach city,518100442002,2014,33222,1215,942,379,563
Virginia Beach city,518100442002,2015,40054,1160,994,561,433
Virginia Beach city,518100442002,2016,32940,1329,962,542,420
Virginia Beach city,518100442002,2017,32973,1450,1158,820,338
Virginia Beach city,518100442002,2018,35553,1474,1020,678,342
Virginia Beach city,518100442002,2019,35333,1540,1135,906,229
Virginia Beach city,518100442003,2014,44904,832,191,34,157
Virginia Beach city,518100442003,2015,49815,1229,244,91,153
Virginia Beach city,518100442003,2016,50110,1351,318,144,174
Virginia Beach city,518100442003,2017,52891,1409,321,158,163
Virginia Beach city,518100442003,2018,67679,1411,294,185,109
Virginia Beach city,518100442003,2019,67950,1234,138,67,71
Virginia Beach city,518100442004,2014,36475,946,501,226,275
Virginia Beach city,518100442004,2015,36644,988,481,239,242
Virginia Beach city,518100442004,2016,53000,973,404,202,202
Virginia Beach city,518100442004,2017,35896,906,474,248,226
Virginia Beach city,518100442004,2018,63651,883,476,226,250
Virginia Beach city,518100442004,2019,84583,1020,395,138,257
Virginia Beach city,518100444011,2014,135852,599,0,0,0
Virginia Beach city,518100444011,2015,137344,588,0,0,0
Virginia Beach city,518100444011,2016,141389,588,0,0,0
Virginia Beach city,518100444011,2017,155526,525,0,0,0
Virginia Beach city,518100444011,2018,160536,696,0,0,0
Virginia Beach city,518100444011,2019,177000,580,0,0,0
Virginia Beach city,518100444011,2020,166771,616,0,0,0
Virginia Beach city,518100444011,2021,182250,434,9,9,0
Virginia Beach city,518100444012,2014,116875,1809,21,21,0
Virginia Beach city,518100444012,2015,106786,1827,16,16,0
Virginia Beach city,518100444012,2016,106094,1836,76,76,0
Virginia Beach city,518100444012,2017,109844,1801,106,106,0
Virginia Beach city,518100444012,2018,101607,1754,123,123,0
Virginia Beach city,518100444012,2019,95903,1779,232,223,9
Virginia Beach city,518100444012,2020,108625,1633,172,165,7
Virginia Beach city,518100444012,2021,102500,1712,299,277,22
Virginia Beach city,518100444013,2014,92167,1017,13,6,7
Virginia Beach city,518100444013,2015,90547,1032,16,8,8
Virginia Beach city,518100444013,2016,95417,988,15,8,7
Virginia Beach city,518100444013,2017,98750,929,18,9,9
Virginia Beach city,518100444013,2018,99028,965,14,7,7
Virginia Beach city,518100444013,2019,107586,1000,0,0,0
Virginia Beach city,518100444013,2020,111867,1067,0,0,0
Virginia Beach city,518100444013,2021,115129,1188,0,0,0
Virginia Beach city,518100444021,2014,69000,2117,186,96,90
Virginia Beach city,518100444021,2015,56359,1990,278,111,167
Virginia Beach city,518100444021,2016,54817,1858,263,97,166
Virginia Beach city,518100444021,2017,62333,1662,185,27,158
Virginia Beach city,518100444021,2018,74271,1760,192,31,161
Virginia Beach city,518100444021,2019,78333,2028,98,17,81
Virginia Beach city,518100444021,2020,91367,2271,92,55,37
Virginia Beach city,518100444021,2021,96750,2437,119,75,44
Virginia Beach city,518100444022,2014,55099,977,0,0,0
Virginia Beach city,518100444022,2015,46417,700,140,0,140
Virginia Beach city,518100444022,2016,45577,728,259,0,259
Virginia Beach city,518100444022,2017,57846,811,320,19,301
Virginia Beach city,518100444022,2018,48664,798,317,18,299
Virginia Beach city,518100444022,2019,51402,765,349,19,330
Virginia Beach city,518100444022,2020,52917,856,50,14,36
Virginia Beach city,518100444022,2021,47045,793,33,16,17
Virginia Beach city,518100444023,2014,67344,1218,61,10,51
Virginia Beach city,518100444023,2015,66136,1245,132,64,68
Virginia Beach city,518100444023,2016,78365,1490,186,133,53
Virginia Beach city,518100444023,2017,81741,1415,180,133,47
Virginia Beach city,518100444023,2018,110708,1677,158,124,34
Virginia Beach city,518100444023,2019,113665,1791,140,125,15
Virginia Beach city,518100444023,2020,112120,1734,68,56,12
Virginia Beach city,518100444023,2021,116814,1477,15,0,15
Virginia Beach city,518100444024,2014,103015,983,0,0,0
Virginia Beach city,518100444024,2015,93158,1001,0,0,0
Virginia Beach city,518100444024,2016,96759,896,0,0,0
Virginia Beach city,518100444024,2017,98935,950,0,0,0
Virginia Beach city,518100444024,2018,99034,880,0,0,0
Virginia Beach city,518100444024,2019,123250,769,0,0,0
Virginia Beach city,518100444024,2020,134722,630,0,0,0
Virginia Beach city,518100444024,2021,160223,929,0,0,0
Virginia Beach city,518100446001,2014,130795,1864,14,0,14
Virginia Beach city,518100446001,2015,123696,1975,14,0,14
Virginia Beach city,518100446001,2016,126309,1564,15,0,15
Virginia Beach city,518100446001,2017,127686,1596,33,17,16
Virginia Beach city,518100446001,2018,122464,1819,29,16,13
Virginia Beach city,518100446001,2019,132604,1958,32,18,14
Virginia Beach city,518100446001,2020,160245,1723,32,18,14
Virginia Beach city,518100446001,2021,155893,1611,79,65,14
Virginia Beach city,518100446002,2014,122431,1317,48,30,18
Virginia Beach city,518100446002,2015,120938,1026,47,28,19
Virginia Beach city,518100446002,2016,121786,1304,54,34,20
Virginia Beach city,518100446002,2017,124000,1244,31,31,0
Virginia Beach city,518100446002,2018,120268,1090,0,0,0
Virginia Beach city,518100446002,2019,122202,1103,0,0,0
Virginia Beach city,518100446002,2020,148214,1138,26,5,21
Virginia Beach city,518100446002,2021,194180,1180,62,7,55
Virginia Beach city,518100446003,2014,164190,811,14,14,0
Virginia Beach city,518100446003,2015,80833,678,20,20,0
Virginia Beach city,518100446003,2016,80368,710,17,17,0
Virginia Beach city,518100446003,2017,95000,695,18,18,0
Virginia Beach city,518100446003,2018,85833,644,16,16,0
Virginia Beach city,518100446003,2019,94083,646,0,0,0
Virginia Beach city,518100446003,2020,135750,515,0,0,0
Virginia Beach city,518100446003,2021,241827,446,37,0,37
Virginia Beach city,518100446004,2014,54441,1508,53,16,37
Virginia Beach city,518100446004,2015,56968,1772,40,15,25
Virginia Beach city,518100446004,2016,56319,1679,28,16,12
Virginia Beach city,518100446004,2017,75795,1552,15,0,15
Virginia Beach city,518100446004,2018,73008,1493,15,0,15
Virginia Beach city,518100446004,2019,83264,1436,17,0,17
Virginia Beach city,518100446004,2020,97842,1771,30,0,30
Virginia Beach city,518100446004,2021,100610,1940,29,0,29
Virginia Beach city,518100448051,2014,38810,1194,253,176,77
Virginia Beach city,518100448051,2015,46471,1249,210,104,106
Virginia Beach city,518100448051,2016,49583,1297,191,95,96
Virginia Beach city,518100448051,2017,52683,1285,143,65,78
Virginia Beach city,518100448051,2018,51594,1277,144,54,90
Virginia Beach city,518100448051,2019,56023,1320,106,30,76
Virginia Beach city,518100448051,2020,54329,1205,48,20,28
Virginia Beach city,518100448051,2021,56442,1019,33,15,18
Virginia Beach city,518100448052,2014,46585,1932,98,98,0
Virginia Beach city,518100448052,2015,46920,1799,116,116,0
Virginia Beach city,518100448052,2016,47917,1813,124,124,0
Virginia Beach city,518100448052,2017,51815,1813,153,132,21
Virginia Beach city,518100448052,2018,57786,1907,96,64,32
Virginia Beach city,518100448052,2019,60493,1959,58,26,32
Virginia Beach city,518100448052,2020,48355,692,0,0,0
Virginia Beach city,518100448052,2021,43333,772,0,0,0
Virginia Beach city,518100448061,2014,37946,1522,458,238,220
Virginia Beach city,518100448061,2015,37292,1432,425,181,244
Virginia Beach city,518100448061,2016,30240,1241,608,327,281
Virginia Beach city,518100448061,2017,28636,1311,729,413,316
Virginia Beach city,518100448061,2018,35676,1266,771,436,335
Virginia Beach city,518100448061,2019,36595,1418,690,433,257
Virginia Beach city,518100448061,2020,38232,1378,576,319,257
Virginia Beach city,518100448061,2021,47862,1530,426,182,244
Virginia Beach city,518100448062,2014,24279,427,305,105,200
Virginia Beach city,518100448062,2015,40236,568,285,106,179
Virginia Beach city,518100448062,2016,51932,657,152,71,81
Virginia Beach city,518100448062,2017,56908,706,122,67,55
Virginia Beach city,518100448062,2018,58854,742,52,52,0
Virginia Beach city,518100448062,2019,61350,631,0,0,0
Virginia Beach city,518100448062,2020,61795,518,0,0,0
Virginia Beach city,518100448062,2021,64758,397,0,0,0
Virginia Beach city,518100448063,2014,36319,464,167,34,133
Virginia Beach city,518100448063,2015,31635,450,189,38,151
Virginia Beach city,518100448063,2016,32434,633,193,28,165
Virginia Beach city,518100448063,2017,39115,593,24,24,0
Virginia Beach city,518100448063,2018,66103,461,11,11,0
Virginia Beach city,518100448063,2019,65972,533,12,12,0
Virginia Beach city,518100448063,2020,62457,542,5,5,0
Virginia Beach city,518100448063,2021,63750,446,7,7,0
Virginia Beach city,518100448071,2014,40089,662,30,0,30
Virginia Beach city,518100448071,2015,55129,724,27,0,27
Virginia Beach city,518100448071,2016,48750,714,30,0,30
Virginia Beach city,518100448071,2017,53894,751,22,0,22
Virginia Beach city,518100448071,2018,71354,533,0,0,0
Virginia Beach city,518100448071,2019,85521,601,0,0,0
Virginia Beach city,518100448071,2020,97585,1174,0,0,0
Virginia Beach city,518100448071,2021,86143,980,0,0,0
Virginia Beach city,518100448072,2014,35722,1979,918,633,285
Virginia Beach city,518100448072,2015,36645,1840,852,628,224
Virginia Beach city,518100448072,2016,40179,1651,365,277,88
Virginia Beach city,518100448072,2017,37763,1761,384,197,187
Virginia Beach city,518100448072,2018,38576,1861,521,211,310
Virginia Beach city,518100448072,2019,43018,2051,328,60,268
Virginia Beach city,518100448072,2020,54651,916,74,36,38
Virginia Beach city,518100448072,2021,57006,838,86,18,68
Virginia Beach city,518100448073,2014,45950,1240,375,128,247
Virginia Beach city,518100448073,2015,45822,1455,382,118,264
Virginia Beach city,518100448073,2016,45634,1631,374,150,224
Virginia Beach city,518100448073,2017,53618,1442,230,174,56
Virginia Beach city,518100448073,2018,54205,1375,243,172,71
Virginia Beach city,518100448073,2019,49877,1294,120,39,81
Virginia Beach city,518100448073,2020,114120,877,9,9,0
Virginia Beach city,518100448073,2021,95903,750,0,0,0
Virginia Beach city,518100448074,2014,107708,462,0,0,0
Virginia Beach city,518100448074,2015,88409,618,0,0,0
Virginia Beach city,518100448074,2016,110529,711,16,16,0
Virginia Beach city,518100448074,2017,91417,863,15,15,0
Virginia Beach city,518100448074,2018,94338,935,14,14,0
Virginia Beach city,518100448074,2019,117518,865,14,14,0
Virginia Beach city,518100448074,2020,32143,460,277,90,187
Virginia Beach city,518100448074,2021,38297,581,347,71,276
Virginia Beach city,518100448081,2014,58143,1955,297,225,72
Virginia Beach city,518100448081,2015,50567,1650,336,210,126
Virginia Beach city,518100448081,2016,50833,1647,249,129,120
Virginia Beach city,518100448081,2017,46313,1613,314,99,215
Virginia Beach city,518100448081,2018,47292,1633,279,82,197
Virginia Beach city,518100448081,2019,44847,1661,282,84,198
Virginia Beach city,518100448081,2020,44029,2002,499,273,226
Virginia Beach city,518100448081,2021,45907,1990,566,363,203
Virginia Beach city,518100448082,2014,72500,624,51,31,20
Virginia Beach city,518100448082,2015,74091,633,52,33,19
Virginia Beach city,518100448082,2016,72833,520,24,10,14
Virginia Beach city,518100448082,2017,73529,554,35,13,22
Virginia Beach city,518100448082,2018,60547,652,38,10,28
Virginia Beach city,518100448082,2019,63235,665,21,9,12
Virginia Beach city,518100448082,2020,63493,691,19,8,11
Virginia Beach city,518100448082,2021,85755,926,45,21,24
Virginia Beach city,518100448083,2014,47813,881,135,52,83
Virginia Beach city,518100448083,2015,48547,1010,172,57,115
Virginia Beach city,518100448083,2016,44028,1057,228,91,137
Virginia Beach city,518100448083,2017,48000,1186,151,66,85
Virginia Beach city,518100448083,2018,45417,1204,260,102,158
Virginia Beach city,518100448083,2019,50847,1384,289,91,198
Virginia Beach city,518100448083,2020,44688,1156,165,64,101
Virginia Beach city,518100448083,2021,54212,994,89,19,70
Virginia Beach city,518100450001,2014,81591,70,40,0,40
Virginia Beach city,518100450001,2015,88438,86,0,0,0
Virginia Beach city,518100450001,2016,88500,88,0,0,0
Virginia Beach city,518100450001,2017,84904,70,0,0,0
Virginia Beach city,518100450001,2018,87250,72,0,0,0
Virginia Beach city,518100450001,2019,0,50,0,0,0
Virginia Beach city,518100450001,2020,109896,65,0,0,0
Virginia Beach city,518100452001,2016,0,0,0,0,0
Virginia Beach city,518100452001,2017,0,0,0,0,0
Virginia Beach city,518100452001,2018,0,0,0,0,0
Virginia Beach city,518100452001,2019,0,0,0,0,0
Virginia Beach city,518100452001,2020,0,0,0,0,0
Virginia Beach city,518100452002,2014,57135,2225,184,60,124
Virginia Beach city,518100452002,2015,53841,2196,200,94,106
Virginia Beach city,518100452002,2016,52197,2191,168,73,95
Virginia Beach city,518100452002,2017,54414,2256,172,45,127
Virginia Beach city,518100452002,2018,54299,2334,229,55,174
Virginia Beach city,518100452002,2019,53913,2196,368,205,163
Virginia Beach city,518100452002,2020,57241,1955,369,235,134
Virginia Beach city,518100452002,2021,63229,2083,346,207,139
Virginia Beach city,518100452003,2014,167708,102,0,0,0
Virginia Beach city,518100452003,2016,0,50,0,0,0
Virginia Beach city,518100452003,2017,0,31,0,0,0
Virginia Beach city,518100452003,2018,0,66,0,0,0
Virginia Beach city,518100452003,2019,0,47,0,0,0
Virginia Beach city,518100452003,2020,0,225,0,0,0
Virginia Beach city,518100454051,2014,53870,660,0,0,0
Virginia Beach city,518100454051,2015,54156,720,8,8,0
Virginia Beach city,518100454051,2016,57222,827,8,8,0
Virginia Beach city,518100454051,2017,60625,795,9,9,0
Virginia Beach city,518100454051,2018,61371,731,19,19,0
Virginia Beach city,518100454051,2019,64316,647,18,18,0
Virginia Beach city,518100454051,2020,61026,667,7,7,0
Virginia Beach city,518100454051,2021,58958,620,7,7,0
Virginia Beach city,518100454052,2014,43929,792,73,13,60
Virginia Beach city,518100454052,2015,45139,1141,57,14,43
Virginia Beach city,518100454052,2016,47163,1258,86,59,27
Virginia Beach city,518100454052,2017,50700,1288,75,43,32
Virginia Beach city,518100454052,2018,56875,1246,68,45,23
Virginia Beach city,518100454052,2019,70545,1504,43,38,5
Virginia Beach city,518100454052,2020,59098,1101,157,146,11
Virginia Beach city,518100454052,2021,62689,1029,100,89,11
Virginia Beach city,518100454053,2014,39535,602,34,10,24
Virginia Beach city,518100454053,2015,40217,739,47,5,42
Virginia Beach city,518100454053,2016,39457,628,55,6,49
Virginia Beach city,518100454053,2017,52000,664,68,14,54
Virginia Beach city,518100454053,2018,63398,807,72,8,64
Virginia Beach city,518100454053,2019,66250,728,103,10,93
Virginia Beach city,518100454053,2020,85139,718,49,15,34
Virginia Beach city,518100454053,2021,83750,701,62,30,32
Virginia Beach city,518100454054,2014,64417,1167,271,39,232
Virginia Beach city,518100454054,2015,67361,920,350,0,350
Virginia Beach city,518100454054,2016,68431,1227,225,0,225
Virginia Beach city,518100454054,2017,66250,827,247,0,247
Virginia Beach city,518100454054,2018,54531,941,115,0,115
Virginia Beach city,518100454054,2019,73032,992,57,20,37
Virginia Beach city,518100454054,2020,53869,1293,68,34,34
Virginia Beach city,518100454054,2021,74231,1173,111,26,85
Virginia Beach city,518100454055,2014,53977,1096,50,6,44
Virginia Beach city,518100454055,2015,53370,771,65,8,57
Virginia Beach city,518100454055,2016,53289,723,48,7,41
Virginia Beach city,518100454055,2017,57434,749,9,9,0
Virginia Beach city,518100454055,2018,56875,644,11,11,0
Virginia Beach city,518100454055,2019,101591,560,0,0,0
Virginia Beach city,518100454055,2020,100093,757,0,0,0
Virginia Beach city,518100454055,2021,99925,725,0,0,0
Virginia Beach city,518100454061,2014,45268,1222,111,84,27
Virginia Beach city,518100454061,2015,40370,1075,199,114,85
Virginia Beach city,518100454061,2016,43617,1140,99,18,81
Virginia Beach city,518100454061,2017,45875,1299,108,17,91
Virginia Beach city,518100454061,2018,45244,1182,133,31,102
Virginia Beach city,518100454061,2019,45319,969,292,33,259
Virginia Beach city,518100454062,2014,37114,747,120,92,28
Virginia Beach city,518100454062,2015,41766,903,89,76,13
Virginia Beach city,518100454062,2016,38750,878,106,75,31
Virginia Beach city,518100454062,2017,45982,1132,91,63,28
Virginia Beach city,518100454062,2018,54201,890,39,9,30
Virginia Beach city,518100454062,2019,0,843,16,0,16
Virginia Beach city,518100454063,2014,54722,1606,237,237,0
Virginia Beach city,518100454063,2015,51728,1884,255,231,24
Virginia Beach city,518100454063,2016,51182,1635,256,235,21
Virginia Beach city,518100454063,2017,50621,1482,267,237,30
Virginia Beach city,518100454063,2018,51768,1518,253,221,32
Virginia Beach city,518100454063,2019,57625,1700,104,14,90
Virginia Beach city,518100454064,2014,114489,2587,105,22,83
Virginia Beach city,518100454064,2015,91042,2379,99,20,79
Virginia Beach city,518100454064,2016,88926,2119,117,31,86
Virginia Beach city,518100454064,2017,93900,2113,64,29,35
Virginia Beach city,518100454064,2018,102885,2054,33,0,33
Virginia Beach city,518100454064,2019,100313,1904,25,0,25
Virginia Beach city,518100454065,2014,70789,2282,105,21,84
Virginia Beach city,518100454065,2015,63198,2711,140,41,99
Virginia Beach city,518100454065,2016,56360,2706,272,33,239
Virginia Beach city,518100454065,2017,58155,2549,255,28,227
Virginia Beach city,518100454065,2018,59553,2935,427,179,248
Virginia Beach city,518100454065,2019,62048,2493,512,199,313
Virginia Beach city,518100454071,2014,53750,1403,187,50,137
Virginia Beach city,518100454071,2015,50326,1253,151,48,103
Virginia Beach city,518100454071,2016,65185,1268,21,10,11
Virginia Beach city,518100454071,2017,76875,1202,17,9,8
Virginia Beach city,518100454071,2018,85761,1423,34,20,14
Virginia Beach city,518100454071,2019,96510,1471,38,22,16
Virginia Beach city,518100454071,2020,87813,1110,23,8,15
Virginia Beach city,518100454071,2021,86786,1240,56,38,18
Virginia Beach city,518100454072,2014,64926,650,0,0,0
Virginia Beach city,518100454072,2015,74345,726,11,11,0
Virginia Beach city,518100454072,2016,73385,659,9,9,0
Virginia Beach city,518100454072,2017,75966,711,11,11,0
Virginia Beach city,518100454072,2018,79676,592,11,11,0
Virginia Beach city,518100454072,2019,60455,607,10,10,0
Virginia Beach city,518100454072,2020,84962,675,93,9,84
Virginia Beach city,518100454072,2021,102759,722,39,18,21
Virginia Beach city,518100454073,2014,53125,1744,9,0,9
Virginia Beach city,518100454073,2015,56667,1887,161,0,161
Virginia Beach city,518100454073,2016,51275,1628,294,30,264
Virginia Beach city,518100454073,2017,61936,1804,288,32,256
Virginia Beach city,518100454073,2018,59219,1587,374,117,257
Virginia Beach city,518100454073,2019,62788,1397,314,61,253
Virginia Beach city,518100454073,2020,64116,1632,261,56,205
Virginia Beach city,518100454073,2021,72969,1890,155,33,122
Virginia Beach city,518100454074,2014,58750,492,143,19,124
Virginia Beach city,518100454074,2015,47344,572,94,0,94
Virginia Beach city,518100454074,2016,52333,641,158,0,158
Virginia Beach city,518100454074,2017,75893,634,154,11,143
Virginia Beach city,518100454074,2018,79926,650,91,11,80
Virginia Beach city,518100454074,2019,80833,649,100,13,87
Virginia Beach city,518100454081,2014,40056,1920,477,330,147
Virginia Beach city,518100454081,2015,46384,2497,287,147,140
Virginia Beach city,518100454081,2016,46782,2360,241,170,71
Virginia Beach city,518100454081,2017,46250,2506,371,277,94
Virginia Beach city,518100454081,2018,51000,2793,361,243,118
Virginia Beach city,518100454081,2019,54063,2619,221,112,109
Virginia Beach city,518100454081,2020,59409,912,66,29,37
Virginia Beach city,518100454081,2021,79904,1262,49,0,49
Virginia Beach city,518100454082,2014,86400,1294,38,38,0
Virginia Beach city,518100454082,2015,60417,981,61,45,16
Virginia Beach city,518100454082,2016,67781,838,87,25,62
Virginia Beach city,518100454082,2017,67962,926,88,25,63
Virginia Beach city,518100454082,2018,62561,486,97,30,67
Virginia Beach city,518100454082,2019,62708,601,105,35,70
Virginia Beach city,518100454082,2020,81298,2292,33,33,0
Virginia Beach city,518100454082,2021,85594,2302,31,31,0
Virginia Beach city,518100454083,2014,81544,561,9,9,0
Virginia Beach city,518100454083,2015,86167,731,0,0,0
Virginia Beach city,518100454083,2016,90313,745,0,0,0
Virginia Beach city,518100454083,2017,89219,578,0,0,0
Virginia Beach city,518100454083,2018,74167,403,0,0,0
Virginia Beach city,518100454083,2019,72963,302,0,0,0
Virginia Beach city,518100454083,2020,0,458,37,0,37
Virginia Beach city,518100454083,2021,47292,312,87,0,87
Virginia Beach city,518100454084,2014,59205,2379,37,21,16
Virginia Beach city,518100454084,2015,60694,2069,39,22,17
Virginia Beach city,518100454084,2016,70357,2212,37,20,17
Virginia Beach city,518100454084,2017,63804,1646,60,44,16
Virginia Beach city,518100454084,2018,62880,1976,58,44,14
Virginia Beach city,518100454084,2019,91923,2078,43,43,0
Virginia Beach city,518100454084,2020,54621,1562,101,82,19
Virginia Beach city,518100454084,2021,57098,1699,37,26,11
Virginia Beach city,518100454121,2014,111118,1690,70,27,43
Virginia Beach city,518100454121,2015,110488,1613,66,27,39
Virginia Beach city,518100454121,2016,106944,1705,100,43,57
Virginia Beach city,518100454121,2017,115972,1593,124,74,50
Virginia Beach city,518100454121,2018,113750,1486,105,75,30
Virginia Beach city,518100454121,2019,99886,1393,101,75,26
Virginia Beach city,518100454121,2020,138056,1521,119,94,25
Virginia Beach city,518100454121,2021,127159,1483,87,87,0
Virginia Beach city,518100454141,2014,49118,1901,633,243,390
Virginia Beach city,518100454141,2015,42048,1976,650,310,340
Virginia Beach city,518100454141,2016,47973,1853,641,423,218
Virginia Beach city,518100454141,2017,66719,1976,485,448,37
Virginia Beach city,518100454141,2018,77336,2345,227,227,0
Virginia Beach city,518100454141,2019,77723,2676,278,259,19
Virginia Beach city,518100454141,2020,76328,432,43,43,0
Virginia Beach city,518100454141,2021,73304,575,278,278,0
Virginia Beach city,518100454142,2014,41719,737,320,18,302
Virginia Beach city,518100454142,2015,52297,780,333,16,317
Virginia Beach city,518100454142,2016,52201,600,339,0,339
Virginia Beach city,518100454142,2017,51822,585,296,0,296
Virginia Beach city,518100454142,2018,73214,704,312,32,280
Virginia Beach city,518100454142,2019,83864,658,106,36,70
Virginia Beach city,518100454142,2020,59218,2275,191,58,133
Virginia Beach city,518100454142,2021,61481,2010,220,99,121
Virginia Beach city,518100454143,2014,39926,987,61,0,61
Virginia Beach city,518100454143,2015,38882,970,74,14,60
Virginia Beach city,518100454143,2016,42656,976,43,13,30
Virginia Beach city,518100454143,2017,55071,1118,27,27,0
Virginia Beach city,518100454143,2018,53382,1336,130,28,102
Virginia Beach city,518100454143,2019,47347,1285,166,36,130
Virginia Beach city,518100454143,2020,83594,631,26,4,22
Virginia Beach city,518100454143,2021,95865,818,22,5,17
Virginia Beach city,518100454144,2014,41729,607,115,2,113
Virginia Beach city,518100454144,2015,42451,775,113,2,111
Virginia Beach city,518100454144,2016,43083,855,153,2,151
Virginia Beach city,518100454144,2017,46250,942,22,3,19
Virginia Beach city,518100454144,2018,61667,623,23,4,19
Virginia Beach city,518100454144,2019,70417,769,26,3,23
Virginia Beach city,518100454144,2020,78073,1249,64,48,16
Virginia Beach city,518100454144,2021,70833,1132,64,51,13
Virginia Beach city,518100454151,2014,75608,1316,20,11,9
Virginia Beach city,518100454151,2015,90000,1172,45,23,22
Virginia Beach city,518100454151,2016,82750,1147,45,19,26
Virginia Beach city,518100454151,2017,84524,1318,17,10,7
Virginia Beach city,518100454151,2018,85463,1247,9,5,4
Virginia Beach city,518100454151,2019,80250,1310,29,24,5
Virginia Beach city,518100454151,2020,66734,1143,308,13,295
Virginia Beach city,518100454151,2021,68319,983,419,21,398
Virginia Beach city,518100454152,2014,61250,564,83,1,82
Virginia Beach city,518100454152,2015,61081,684,45,1,44
Virginia Beach city,518100454152,2016,63558,627,71,1,70
Virginia Beach city,518100454152,2017,63550,610,134,8,126
Virginia Beach city,518100454152,2018,66827,593,114,5,109
Virginia Beach city,518100454152,2019,70938,570,118,10,108
Virginia Beach city,518100454152,2020,73750,584,94,11,83
Virginia Beach city,518100454152,2021,75929,611,90,11,79
Virginia Beach city,518100454171,2014,90536,1343,56,36,20
Virginia Beach city,518100454171,2015,90444,1264,58,36,22
Virginia Beach city,518100454171,2016,92952,1802,38,15,23
Virginia Beach city,518100454171,2017,77426,2084,34,14,20
Virginia Beach city,518100454171,2018,81210,2173,79,56,23
Virginia Beach city,518100454171,2019,84042,2025,49,49,0
Virginia Beach city,518100454172,2014,90288,2274,183,14,169
Virginia Beach city,518100454172,2015,84459,2337,130,13,117
Virginia Beach city,518100454172,2016,98750,2491,233,88,145
Virginia Beach city,518100454172,2017,104801,2514,260,132,128
Virginia Beach city,518100454172,2018,109688,2079,327,185,142
Virginia Beach city,518100454172,2019,128667,1886,351,197,154
Virginia Beach city,518100454173,2014,105329,865,33,33,0
Virginia Beach city,518100454173,2015,94615,1038,27,27,0
Virginia Beach city,518100454173,2016,89760,1091,12,12,0
Virginia Beach city,518100454173,2017,92188,1064,13,13,0
Virginia Beach city,518100454173,2018,88661,1067,21,9,12
Virginia Beach city,518100454173,2019,110438,946,7,0,7
Virginia Beach city,518100454174,2014,95685,4183,20,20,0
Virginia Beach city,518100454174,2015,92042,4325,0,0,0
Virginia Beach city,518100454174,2016,98231,3826,0,0,0
Virginia Beach city,518100454174,2017,102417,3504,0,0,0
Virginia Beach city,518100454174,2018,105030,3546,0,0,0
Virginia Beach city,518100454174,2019,106986,3833,0,0,0
Virginia Beach city,518100454201,2014,78411,1994,205,53,152
Virginia Beach city,518100454201,2015,78535,1966,200,58,142
Virginia Beach city,518100454201,2016,79622,1964,167,47,120
Virginia Beach city,518100454201,2017,83787,1946,96,44,52
Virginia Beach city,518100454201,2018,87344,2444,52,0,52
Virginia Beach city,518100454201,2019,97917,2432,81,24,57
Virginia Beach city,518100454201,2020,105333,2372,434,22,412
Virginia Beach city,518100454201,2021,106125,2261,457,23,434
Virginia Beach city,518100454202,2014,84615,1114,30,30,0
Virginia Beach city,518100454202,2015,87056,1219,7,7,0
Virginia Beach city,518100454202,2016,94750,1022,7,7,0
Virginia Beach city,518100454202,2017,116111,1044,9,9,0
Virginia Beach city,518100454202,2018,97841,1045,9,9,0
Virginia Beach city,518100454202,2019,104028,1061,20,20,0
Virginia Beach city,518100454202,2020,82750,927,25,25,0
Virginia Beach city,518100454202,2021,85529,1104,43,43,0
Virginia Beach city,518100454203,2014,135500,1674,31,13,18
Virginia Beach city,518100454203,2015,148194,1748,32,14,18
Virginia Beach city,518100454203,2016,162543,1810,0,0,0
Virginia Beach city,518100454203,2017,175945,1802,0,0,0
Virginia Beach city,518100454203,2018,181140,1939,0,0,0
Virginia Beach city,518100454203,2019,183194,1941,16,0,16
Virginia Beach city,518100454203,2020,185670,1769,16,0,16
Virginia Beach city,518100454203,2021,164028,1891,53,10,43
Virginia Beach city,518100454211,2014,126031,1754,45,10,35
Virginia Beach city,518100454211,2015,127423,1730,49,10,39
Virginia Beach city,518100454211,2016,129375,1554,72,11,61
Virginia Beach city,518100454211,2017,119514,1261,29,11,18
Virginia Beach city,518100454211,2018,125042,1295,57,15,42
Virginia Beach city,518100454211,2019,118068,1346,45,0,45
Virginia Beach city,518100454211,2020,126250,1117,50,0,50
Virginia Beach city,518100454211,2021,133125,1202,43,0,43
Virginia Beach city,518100454212,2014,107778,1588,27,0,27
Virginia Beach city,518100454212,2015,86964,1537,24,0,24
Virginia Beach city,518100454212,2016,83813,1928,59,30,29
Virginia Beach city,518100454212,2017,88400,2249,69,34,35
Virginia Beach city,518100454212,2018,104042,2158,57,29,28
Virginia Beach city,518100454212,2019,93793,2242,90,78,12
Virginia Beach city,518100454212,2020,77821,2309,93,81,12
Virginia Beach city,518100454212,2021,96364,2281,41,41,0
Virginia Beach city,518100454221,2014,91411,1922,10,0,10
Virginia Beach city,518100454221,2015,88409,1829,10,0,10
Virginia Beach city,518100454221,2016,101711,1873,8,0,8
Virginia Beach city,518100454221,2017,103836,1936,9,0,9
Virginia Beach city,518100454221,2018,108015,1799,9,0,9
Virginia Beach city,518100454221,2019,112917,1801,46,0,46
Virginia Beach city,518100454221,2020,115625,1761,112,0,112
Virginia Beach city,518100454221,2021,121635,1741,99,0,99
Virginia Beach city,518100454222,2014,97541,3056,96,46,50
Virginia Beach city,518100454222,2015,101319,2984,76,66,10
Virginia Beach city,518100454222,2016,94132,2823,66,52,14
Virginia Beach city,518100454222,2017,94030,2663,65,53,12
Virginia Beach city,518100454222,2018,94032,2546,64,61,3
Virginia Beach city,518100454222,2019,84952,2445,97,64,33
Virginia Beach city,518100454222,2020,82639,2152,94,58,36
Virginia Beach city,518100454222,2021,87694,2214,97,59,38
Virginia Beach city,518100454231,2014,138594,2126,171,78,93
Virginia Beach city,518100454231,2015,126591,2134,141,52,89
Virginia Beach city,518100454231,2016,113182,2318,132,56,76
Virginia Beach city,518100454231,2017,111058,2492,101,70,31
Virginia Beach city,518100454231,2018,118558,2161,97,97,0
Virginia Beach city,518100454231,2019,116964,2100,72,72,0
Virginia Beach city,518100454232,2014,92639,582,33,20,13
Virginia Beach city,518100454232,2015,76875,563,33,18,15
Virginia Beach city,518100454232,2016,82188,609,33,19,14
Virginia Beach city,518100454232,2017,72123,831,39,22,17
Virginia Beach city,518100454232,2018,87833,643,9,9,0
Virginia Beach city,518100454232,2019,76528,587,10,10,0
Virginia Beach city,518100454233,2014,96228,4554,123,21,102
Virginia Beach city,518100454233,2015,95882,4436,47,15,32
Virginia Beach city,518100454233,2016,90487,4142,153,125,28
Virginia Beach city,518100454233,2017,83438,4429,233,143,90
Virginia Beach city,518100454233,2018,89667,4422,229,127,102
Virginia Beach city,518100454233,2019,103426,4476,218,82,136
Virginia Beach city,518100454241,2014,83438,1917,15,15,0
Virginia Beach city,518100454241,2015,85536,1722,13,13,0
Virginia Beach city,518100454241,2016,85655,1883,19,19,0
Virginia Beach city,518100454241,2017,81339,1960,21,21,0
Virginia Beach city,518100454241,2018,91136,1837,24,13,11
Virginia Beach city,518100454241,2019,93750,1746,9,0,9
Virginia Beach city,518100454241,2020,80459,1753,82,73,9
Virginia Beach city,518100454241,2021,83464,1814,133,122,11
Virginia Beach city,518100454242,2014,135142,2822,55,55,0
Virginia Beach city,518100454242,2015,135074,3311,46,46,0
Virginia Beach city,518100454242,2016,138243,3493,56,56,0
Virginia Beach city,518100454242,2017,135491,3417,73,14,59
Virginia Beach city,518100454242,2018,151750,3744,15,15,0
Virginia Beach city,518100454242,2019,160417,4169,43,0,43
Virginia Beach city,518100454242,2020,162865,3760,82,36,46
Virginia Beach city,518100454242,2021,167328,4091,110,57,53
Virginia Beach city,518100454251,2014,85030,1507,83,75,8
Virginia Beach city,518100454251,2015,75000,1572,149,137,12
Virginia Beach city,518100454251,2016,77868,1617,157,133,24
Virginia Beach city,518100454251,2017,78606,1680,202,152,50
Virginia Beach city,518100454251,2018,88864,1779,108,60,48
Virginia Beach city,518100454251,2019,92212,1997,75,62,13
Virginia Beach city,518100454251,2020,103750,2201,280,45,235
Virginia Beach city,518100454251,2021,104091,2298,344,51,293
Virginia Beach city,518100454252,2014,85313,1319,69,20,49
Virginia Beach city,518100454252,2015,67813,1052,74,31,43
Virginia Beach city,518100454252,2016,80625,994,83,26,57
Virginia Beach city,518100454252,2017,73393,816,97,37,60
Virginia Beach city,518100454252,2018,78500,761,121,43,78
Virginia Beach city,518100454252,2019,95625,665,76,43,33
Virginia Beach city,518100454252,2020,104063,607,54,16,38
Virginia Beach city,518100454252,2021,113333,670,51,17,34
Virginia Beach city,518100454261,2014,69250,2109,229,0,229
Virginia Beach city,518100454261,2015,74750,2109,275,0,275
Virginia Beach city,518100454261,2016,85000,2122,240,0,240
Virginia Beach city,518100454261,2017,93750,1777,264,0,264
Virginia Beach city,518100454261,2018,101760,1731,232,20,212
Virginia Beach city,518100454261,2019,104737,1909,33,33,0
Virginia Beach city,518100454261,2020,105270,1893,16,16,0
Virginia Beach city,518100454261,2021,112102,1996,32,32,0
Virginia Beach city,518100454262,2014,90515,2037,49,0,49
Virginia Beach city,518100454262,2015,83958,1982,270,206,64
Virginia Beach city,518100454262,2016,93571,2005,223,214,9
Virginia Beach city,518100454262,2017,89276,1990,231,222,9
Virginia Beach city,518100454262,2018,91648,2048,238,238,0
Virginia Beach city,518100454262,2019,108897,1853,318,318,0
Virginia Beach city,518100454262,2020,108864,2054,120,120,0
Virginia Beach city,518100454262,2021,108254,2107,90,90,0
Virginia Beach city,518100454263,2014,111354,2065,36,36,0
Virginia Beach city,518100454263,2015,99706,1928,137,137,0
Virginia Beach city,518100454263,2016,111250,1868,132,132,0
Virginia Beach city,518100454263,2017,111583,1864,209,209,0
Virginia Beach city,518100454263,2018,126463,2049,200,200,0
Virginia Beach city,518100454263,2019,121280,2150,226,226,0
Virginia Beach city,518100454263,2020,145273,2180,154,154,0
Virginia Beach city,518100454263,2021,124665,2297,230,230,0
Virginia Beach city,518100454271,2014,76744,1593,124,104,20
Virginia Beach city,518100454271,2015,77446,1643,140,114,26
Virginia Beach city,518100454271,2016,81000,1394,97,97,0
Virginia Beach city,518100454271,2017,97969,1285,75,75,0
Virginia Beach city,518100454271,2018,111495,1454,0,0,0
Virginia Beach city,518100454271,2019,113271,1106,0,0,0
Virginia Beach city,518100454271,2020,113618,1351,0,0,0
Virginia Beach city,518100454271,2021,120191,1266,0,0,0
Virginia Beach city,518100454272,2014,85030,1053,74,54,20
Virginia Beach city,518100454272,2015,75911,892,60,45,15
Virginia Beach city,518100454272,2016,75795,944,103,89,14
Virginia Beach city,518100454272,2017,74906,1003,122,103,19
Virginia Beach city,518100454272,2018,92000,920,94,94,0
Virginia Beach city,518100454272,2019,95417,1057,52,52,0
Virginia Beach city,518100454272,2020,94904,936,32,32,0
Virginia Beach city,518100454272,2021,81419,953,0,0,0
Virginia Beach city,518100454273,2014,73598,2064,427,397,30
Virginia Beach city,518100454273,2015,54786,2128,392,347,45
Virginia Beach city,518100454273,2016,64904,2416,201,113,88
Virginia Beach city,518100454273,2017,70815,2472,0,0,0
Virginia Beach city,518100454273,2018,78172,2327,0,0,0
Virginia Beach city,518100454273,2019,78212,2061,19,0,19
Virginia Beach city,518100454273,2020,80840,1827,16,0,16
Virginia Beach city,518100454273,2021,75545,2156,16,0,16
Virginia Beach city,518100454274,2014,58636,1044,326,100,226
Virginia Beach city,518100454274,2015,84655,1122,208,71,137
Virginia Beach city,518100454274,2016,58516,1221,271,130,141
Virginia Beach city,518100454274,2017,60956,1382,206,163,43
Virginia Beach city,518100454274,2018,86974,1406,87,46,41
Virginia Beach city,518100454274,2019,87695,1419,111,66,45
Virginia Beach city,518100454274,2020,59184,1466,78,78,0
Virginia Beach city,518100454274,2021,81719,1317,16,16,0
Virginia Beach city,518100454281,2014,54038,1287,133,98,35
Virginia Beach city,518100454281,2015,50650,1251,109,92,17
Virginia Beach city,518100454281,2016,63512,1263,52,36,16
Virginia Beach city,518100454281,2017,69948,1287,65,35,30
Virginia Beach city,518100454281,2018,68750,1271,82,42,40
Virginia Beach city,518100454281,2019,66563,1311,78,56,22
Virginia Beach city,518100454281,2020,73661,1212,99,75,24
Virginia Beach city,518100454281,2021,79408,1163,99,77,22
Virginia Beach city,518100456011,2014,99135,873,0,0,0
Virginia Beach city,518100456011,2015,105430,849,0,0,0
Virginia Beach city,518100456011,2016,85536,834,8,8,0
Virginia Beach city,518100456011,2017,87844,773,9,9,0
Virginia Beach city,518100456011,2018,90120,661,8,8,0
Virginia Beach city,518100456011,2019,92176,778,20,20,0
Virginia Beach city,518100456011,2020,93693,685,20,20,0
Virginia Beach city,518100456011,2021,136389,805,19,10,9
Virginia Beach city,518100456012,2014,74735,1877,52,12,40
Virginia Beach city,518100456012,2015,70563,1962,51,11,40
Virginia Beach city,518100456012,2016,77578,1997,67,22,45
Virginia Beach city,518100456012,2017,76563,2045,68,26,42
Virginia Beach city,518100456012,2018,75472,2038,79,29,50
Virginia Beach city,518100456012,2019,76736,2047,105,56,49
Virginia Beach city,518100456012,2020,77614,1944,166,93,73
Virginia Beach city,518100456012,2021,80800,1882,145,108,37
Virginia Beach city,518100456031,2014,41223,579,54,35,19
Virginia Beach city,518100456031,2015,42011,633,76,31,45
Virginia Beach city,518100456031,2016,42865,573,65,10,55
Virginia Beach city,518100456031,2017,40705,620,87,6,81
Virginia Beach city,518100456031,2018,42716,578,93,9,84
Virginia Beach city,518100456031,2019,41681,610,102,8,94
Virginia Beach city,518100456031,2020,38214,639,20,7,13
Virginia Beach city,518100456031,2021,39495,755,85,70,15
Virginia Beach city,518100456032,2014,76165,1066,11,11,0
Virginia Beach city,518100456032,2015,75530,1068,9,9,0
Virginia Beach city,518100456032,2016,68580,970,7,7,0
Virginia Beach city,518100456032,2017,68304,927,27,15,12
Virginia Beach city,518100456032,2018,77500,1070,46,0,46
Virginia Beach city,518100456032,2019,61339,1108,66,10,56
Virginia Beach city,518100456032,2020,61098,1005,59,9,50
Virginia Beach city,518100456032,2021,63043,1069,69,16,53
Virginia Beach city,518100456041,2014,42778,1435,564,94,470
Virginia Beach city,518100456041,2015,50288,1399,502,52,450
Virginia Beach city,518100456041,2016,52212,1407,360,47,313
Virginia Beach city,518100456041,2017,56181,1372,363,30,333
Virginia Beach city,518100456041,2018,42404,1120,440,91,349
Virginia Beach city,518100456041,2019,48468,1019,192,42,150
Virginia Beach city,518100456042,2014,52917,2118,107,48,59
Virginia Beach city,518100456042,2015,47056,2190,64,24,40
Virginia Beach city,518100456042,2016,46185,2092,63,28,35
Virginia Beach city,518100456042,2017,47844,2412,45,23,22
Virginia Beach city,518100456042,2018,47741,2362,34,11,23
Virginia Beach city,518100456042,2019,48218,2188,40,11,29
Virginia Beach city,518100456043,2014,45673,1987,265,99,166
Virginia Beach city,518100456043,2015,45000,2039,308,108,200
Virginia Beach city,518100456043,2016,48659,2209,382,98,284
Virginia Beach city,518100456043,2017,47800,1786,327,73,254
Virginia Beach city,518100456043,2018,52368,2141,154,93,61
Virginia Beach city,518100456043,2019,56826,2692,241,36,205
Virginia Beach city,518100458011,2014,76591,2357,123,65,58
Virginia Beach city,518100458011,2015,78086,2047,298,96,202
Virginia Beach city,518100458011,2016,81667,2150,306,78,228
Virginia Beach city,518100458011,2017,93750,2109,275,84,191
Virginia Beach city,518100458011,2018,84148,1957,163,69,94
Virginia Beach city,518100458011,2019,86250,1990,146,81,65
Virginia Beach city,518100458011,2020,87083,1919,101,79,22
Virginia Beach city,518100458011,2021,84375,1964,112,95,17
Virginia Beach city,518100458012,2014,75721,815,16,15,1
Virginia Beach city,518100458012,2015,73986,832,27,24,3
Virginia Beach city,518100458012,2016,73925,931,28,26,2
Virginia Beach city,518100458012,2017,69861,1058,27,25,2
Virginia Beach city,518100458012,2018,64632,996,154,29,125
Virginia Beach city,518100458012,2019,66563,1050,116,32,84
Virginia Beach city,518100458012,2020,76069,1086,82,29,53
Virginia Beach city,518100458012,2021,80238,923,96,36,60
Virginia Beach city,518100458013,2014,53173,926,112,101,11
Virginia Beach city,518100458013,2015,50625,937,141,72,69
Virginia Beach city,518100458013,2016,54821,935,164,89,75
Virginia Beach city,518100458013,2017,69464,893,114,60,54
Virginia Beach city,518100458013,2018,62500,915,150,71,79
Virginia Beach city,518100458013,2019,61677,910,184,77,107
Virginia Beach city,518100458013,2020,58735,1238,112,68,44
Virginia Beach city,518100458013,2021,62195,1353,107,59,48
Virginia Beach city,518100458031,2014,51875,1305,45,28,17
Virginia Beach city,518100458031,2015,54846,1352,63,21,42
Virginia Beach city,518100458031,2016,54680,1314,53,15,38
Virginia Beach city,518100458031,2017,57292,1424,47,13,34
Virginia Beach city,518100458031,2018,57461,1379,81,21,60
Virginia Beach city,518100458031,2019,59859,1554,110,24,86
Virginia Beach city,518100458031,2020,58088,1774,76,22,54
Virginia Beach city,518100458031,2021,56809,1687,150,50,100
Virginia Beach city,518100458032,2014,74972,1692,23,9,14
Virginia Beach city,518100458032,2015,88750,1509,37,22,15
Virginia Beach city,518100458032,2016,100341,1618,48,28,20
Virginia Beach city,518100458032,2017,103438,1518,50,29,21
Virginia Beach city,518100458032,2018,105357,1534,41,18,23
Virginia Beach city,518100458032,2019,101473,1480,34,15,19
Virginia Beach city,518100458032,2020,111912,2172,0,0,0
Virginia Beach city,518100458032,2021,115574,2197,0,0,0
Virginia Beach city,518100458051,2014,73750,1179,189,137,52
Virginia Beach city,518100458051,2015,67857,1204,143,102,41
Virginia Beach city,518100458051,2016,69875,1237,92,47,45
Virginia Beach city,518100458051,2017,80278,1296,34,0,34
Virginia Beach city,518100458051,2018,83929,1357,16,0,16
Virginia Beach city,518100458051,2019,82292,1325,7,7,0
Virginia Beach city,518100458051,2020,98750,1180,15,6,9
Virginia Beach city,518100458051,2021,92255,1195,20,4,16
Virginia Beach city,518100458061,2014,68382,1949,81,80,1
Virginia Beach city,518100458061,2015,69438,1700,48,46,2
Virginia Beach city,518100458061,2016,63929,1763,15,14,1
Virginia Beach city,518100458061,2017,66042,1759,45,44,1
Virginia Beach city,518100458061,2018,72550,1584,17,15,2
Virginia Beach city,518100458061,2019,68107,1556,40,38,2
Virginia Beach city,518100458061,2020,68352,1647,55,53,2
Virginia Beach city,518100458061,2021,78125,1930,74,56,18
Virginia Beach city,518100458062,2014,57426,616,141,52,89
Virginia Beach city,518100458062,2015,48500,665,235,163,72
Virginia Beach city,518100458062,2016,39302,765,249,166,83
Virginia Beach city,518100458062,2017,39406,722,204,141,63
Virginia Beach city,518100458062,2018,41964,796,155,118,37
Virginia Beach city,518100458062,2019,48663,988,113,102,11
Virginia Beach city,518100458062,2020,0,989,10,0,10
Virginia Beach city,518100458063,2014,48281,1055,256,154,102
Virginia Beach city,518100458063,2015,49393,1247,241,128,113
Virginia Beach city,518100458063,2016,53170,962,233,112,121
Virginia Beach city,518100458063,2017,53750,889,305,89,216
Virginia Beach city,518100458063,2018,56576,1126,204,11,193
Virginia Beach city,518100458063,2019,55613,1036,147,12,135
Virginia Beach city,518100458063,2020,44971,872,180,75,105
Virginia Beach city,518100458063,2021,47413,966,215,61,154
Virginia Beach city,518100458071,2014,49403,1370,145,112,33
Virginia Beach city,518100458071,2015,48393,1368,169,120,49
Virginia Beach city,518100458071,2016,49787,1339,202,146,56
Virginia Beach city,518100458071,2017,50855,1452,167,117,50
Virginia Beach city,518100458071,2018,51688,1481,52,39,13
Virginia Beach city,518100458071,2019,54000,1476,51,33,18
Virginia Beach city,518100458071,2020,66271,1443,27,27,0
Virginia Beach city,518100458071,2021,68571,1378,7,7,0
Virginia Beach city,518100458081,2014,71500,1628,94,65,29
Virginia Beach city,518100458081,2015,71094,1770,90,68,22
Virginia Beach city,518100458081,2016,62375,1890,123,95,28
Virginia Beach city,518100458081,2017,77708,2151,76,42,34
Virginia Beach city,518100458081,2018,78036,1998,104,54,50
Virginia Beach city,518100458081,2019,78098,1886,143,54,89
Virginia Beach city,518100458081,2020,59844,2304,359,126,233
Virginia Beach city,518100458081,2021,57188,2063,421,129,292
Virginia Beach city,518100458082,2014,64531,772,102,40,62
Virginia Beach city,518100458082,2015,90250,775,72,3,69
Virginia Beach city,518100458082,2016,66111,604,98,15,83
Virginia Beach city,518100458082,2017,57292,565,85,14,71
Virginia Beach city,518100458082,2018,67266,647,54,9,45
Virginia Beach city,518100458082,2019,91722,696,226,8,218
Virginia Beach city,518100458082,2020,89063,800,213,8,205
Virginia Beach city,518100458082,2021,85357,722,184,29,155
Virginia Beach city,518100458091,2014,75571,1217,129,66,63
Virginia Beach city,518100458091,2015,80565,1329,166,78,88
Virginia Beach city,518100458091,2016,81935,1041,84,27,57
Virginia Beach city,518100458091,2017,82796,950,49,0,49
Virginia Beach city,518100458091,2018,85743,923,59,0,59
Virginia Beach city,518100458091,2019,85038,1035,0,0,0
Virginia Beach city,518100458091,2020,91642,1288,0,0,0
Virginia Beach city,518100458091,2021,95242,1676,0,0,0
Virginia Beach city,518100458092,2014,64306,1034,171,171,0
Virginia Beach city,518100458092,2015,49848,874,194,194,0
Virginia Beach city,518100458092,2016,63017,651,179,179,0
Virginia Beach city,518100458092,2017,67727,688,31,31,0
Virginia Beach city,518100458092,2018,85104,784,33,33,0
Virginia Beach city,518100458092,2019,84417,643,44,44,0
Virginia Beach city,518100458092,2020,89194,837,0,0,0
Virginia Beach city,518100458092,2021,93077,1003,0,0,0
Virginia Beach city,518100458093,2014,55795,2981,178,60,118
Virginia Beach city,518100458093,2015,62132,3052,103,55,48
Virginia Beach city,518100458093,2016,61987,3187,119,58,61
Virginia Beach city,518100458093,2017,64257,3028,0,0,0
Virginia Beach city,518100458093,2018,63902,2963,26,26,0
Virginia Beach city,518100458093,2019,66563,2711,35,25,10
Virginia Beach city,518100458093,2020,62857,621,0,0,0
Virginia Beach city,518100458093,2021,65601,552,54,54,0
Virginia Beach city,518100458094,2014,49917,732,281,15,266
Virginia Beach city,518100458094,2015,49583,893,336,14,322
Virginia Beach city,518100458094,2016,41611,836,225,17,208
Virginia Beach city,518100458094,2017,42003,751,0,0,0
Virginia Beach city,518100458094,2018,62813,820,0,0,0
Virginia Beach city,518100458094,2019,61489,821,0,0,0
Virginia Beach city,518100458094,2020,46111,1258,11,0,11
Virginia Beach city,518100458094,2021,55324,1520,9,0,9
Virginia Beach city,518100458101,2014,39773,1380,884,535,349
Virginia Beach city,518100458101,2015,40521,1297,931,565,366
Virginia Beach city,518100458101,2016,36250,1216,1043,608,435
Virginia Beach city,518100458101,2017,41146,1293,830,447,383
Virginia Beach city,518100458101,2018,31767,1195,928,443,485
Virginia Beach city,518100458101,2019,31250,1248,916,412,504
Virginia Beach city,518100458101,2020,31063,1835,886,297,589
Virginia Beach city,518100458101,2021,33646,1867,912,363,549
Virginia Beach city,518100460021,2014,79519,1635,146,112,34
Virginia Beach city,518100460021,2015,81141,1727,133,53,80
Virginia Beach city,518100460021,2016,89821,1734,114,57,57
Virginia Beach city,518100460021,2017,76850,1772,152,91,61
Virginia Beach city,518100460021,2018,94063,1809,117,55,62
Virginia Beach city,518100460021,2019,95625,1670,132,69,63
Virginia Beach city,518100460021,2020,108958,1625,65,30,35
Virginia Beach city,518100460021,2021,98214,1735,49,19,30
Virginia Beach city,518100460022,2014,70774,1112,152,0,152
Virginia Beach city,518100460022,2015,83984,1040,31,0,31
Virginia Beach city,518100460022,2016,82857,1219,21,0,21
Virginia Beach city,518100460022,2017,85819,1354,29,0,29
Virginia Beach city,518100460022,2018,103875,1327,23,0,23
Virginia Beach city,518100460022,2019,106375,1403,24,16,8
Virginia Beach city,518100460022,2020,98875,1402,69,51,18
Virginia Beach city,518100460022,2021,118125,1170,66,58,8
Virginia Beach city,518100460023,2014,55750,532,12,0,12
Virginia Beach city,518100460023,2015,65882,717,0,0,0
Virginia Beach city,518100460023,2016,79625,782,116,116,0
Virginia Beach city,518100460023,2017,87679,769,121,121,0
Virginia Beach city,518100460023,2018,72250,872,144,134,10
Virginia Beach city,518100460023,2019,71349,913,201,119,82
Virginia Beach city,518100460023,2020,66633,1158,247,168,79
Virginia Beach city,518100460023,2021,67125,1280,156,34,122
Virginia Beach city,518100460024,2014,102000,1126,32,1,31
Virginia Beach city,518100460024,2015,94737,1114,52,12,40
Virginia Beach city,518100460024,2016,101397,1092,58,13,45
Virginia Beach city,518100460024,2017,99896,1079,43,13,30
Virginia Beach city,518100460024,2018,101080,1077,45,12,33
Virginia Beach city,518100460024,2019,79471,1038,46,11,35
Virginia Beach city,518100460024,2020,80625,930,38,20,18
Virginia Beach city,518100460024,2021,93438,1091,29,17,12
Virginia Beach city,518100460051,2014,60707,916,107,27,80
Virginia Beach city,518100460051,2015,63683,1020,139,35,104
Virginia Beach city,518100460051,2016,63879,1230,190,55,135
Virginia Beach city,518100460051,2017,66343,1310,228,114,114
Virginia Beach city,518100460051,2018,80385,1965,238,116,122
Virginia Beach city,518100460051,2019,83172,2237,319,160,159
Virginia Beach city,518100460052,2014,66271,1365,66,55,11
Virginia Beach city,518100460052,2015,63839,1137,55,55,0
Virginia Beach city,518100460052,2016,65605,1076,50,50,0
Virginia Beach city,518100460052,2017,67813,1104,57,57,0
Virginia Beach city,518100460052,2018,63190,1028,15,0,15
Virginia Beach city,518100460052,2019,71064,1279,29,14,15
Virginia Beach city,518100460053,2014,70260,2143,119,19,100
Virginia Beach city,518100460053,2015,64949,1955,115,15,100
Virginia Beach city,518100460053,2016,64692,2218,186,68,118
Virginia Beach city,518100460053,2017,73306,2303,154,36,118
Virginia Beach city,518100460053,2018,77266,2288,124,38,86
Virginia Beach city,518100460053,2019,78167,3005,15,15,0
Virginia Beach city,518100460054,2014,44766,1604,424,320,104
Virginia Beach city,518100460054,2015,42679,1758,396,293,103
Virginia Beach city,518100460054,2016,49583,1826,52,52,0
Virginia Beach city,518100460054,2017,49333,1611,383,383,0
Virginia Beach city,518100460054,2018,43333,1297,466,466,0
Virginia Beach city,518100460054,2019,52759,1225,283,283,0
Virginia Beach city,518100460061,2014,87361,880,37,26,11
Virginia Beach city,518100460061,2015,85333,817,24,0,24
Virginia Beach city,518100460061,2016,88011,842,12,0,12
Virginia Beach city,518100460061,2017,92344,758,7,0,7
Virginia Beach city,518100460061,2018,105119,962,8,0,8
Virginia Beach city,518100460061,2019,96094,910,8,0,8
Virginia Beach city,518100460061,2020,106645,809,0,0,0
Virginia Beach city,518100460061,2021,111719,755,0,0,0
Virginia Beach city,518100460062,2014,93214,1095,0,0,0
Virginia Beach city,518100460062,2015,91250,962,0,0,0
Virginia Beach city,518100460062,2016,66875,951,0,0,0
Virginia Beach city,518100460062,2017,92188,947,0,0,0
Virginia Beach city,518100460062,2018,96691,803,0,0,0
Virginia Beach city,518100460062,2019,104063,989,13,0,13
Virginia Beach city,518100460062,2020,106944,1016,13,0,13
Virginia Beach city,518100460062,2021,128125,1058,20,6,14
Virginia Beach city,518100460063,2014,77946,929,39,9,30
Virginia Beach city,518100460063,2015,86071,1009,34,7,27
Virginia Beach city,518100460063,2016,98009,997,39,8,31
Virginia Beach city,518100460063,2017,100432,743,29,5,24
Virginia Beach city,518100460063,2018,103036,926,31,5,26
Virginia Beach city,518100460063,2019,99728,1060,0,0,0
Virginia Beach city,518100460063,2020,108056,806,0,0,0
Virginia Beach city,518100460063,2021,114537,924,9,9,0
Virginia Beach city,518100460064,2014,62011,1543,133,0,133
Virginia Beach city,518100460064,2015,61806,1673,130,0,130
Virginia Beach city,518100460064,2016,70000,1648,0,0,0
Virginia Beach city,518100460064,2017,64612,1799,81,33,48
Virginia Beach city,518100460064,2018,76089,1482,91,34,57
Virginia Beach city,518100460064,2019,83654,1279,69,25,44
Virginia Beach city,518100460064,2020,79081,923,80,28,52
Virginia Beach city,518100460064,2021,86406,834,153,73,80
Virginia Beach city,518100460091,2014,66193,1054,13,0,13
Virginia Beach city,518100460091,2015,68371,1194,20,6,14
Virginia Beach city,518100460091,2016,68926,1266,5,5,0
Virginia Beach city,518100460091,2017,76833,1061,18,18,0
Virginia Beach city,518100460091,2018,80469,1380,38,31,7
Virginia Beach city,518100460091,2019,86656,1357,44,35,9
Virginia Beach city,518100460091,2020,89358,1180,62,52,10
Virginia Beach city,518100460091,2021,90864,1372,118,93,25
Virginia Beach city,518100460092,2014,74205,1625,37,29,8
Virginia Beach city,518100460092,2015,63125,1463,41,34,7
Virginia Beach city,518100460092,2016,57250,1628,3,3,0
Virginia Beach city,518100460092,2017,58098,1878,15,15,0
Virginia Beach city,518100460092,2018,57390,1390,289,34,255
Virginia Beach city,518100460092,2019,55875,1463,323,38,285
Virginia Beach city,518100460092,2020,63684,1303,394,36,358
Virginia Beach city,518100460092,2021,81250,1210,388,47,341
Virginia Beach city,518100460093,2014,70781,978,43,43,0
Virginia Beach city,518100460093,2015,75809,870,10,0,10
Virginia Beach city,518100460093,2016,72222,874,26,0,26
Virginia Beach city,518100460093,2017,73125,919,24,0,24
Virginia Beach city,518100460093,2018,57059,805,26,0,26
Virginia Beach city,518100460093,2019,55903,749,30,0,30
Virginia Beach city,518100460093,2020,51953,701,21,0,21
Virginia Beach city,518100460093,2021,53958,627,30,30,0
Virginia Beach city,518100460094,2014,91538,1128,42,0,42
Virginia Beach city,518100460094,2015,100179,1123,49,0,49
Virginia Beach city,518100460094,2016,99708,1078,65,11,54
Virginia Beach city,518100460094,2017,91563,1183,105,37,68
Virginia Beach city,518100460094,2018,80813,1405,42,36,6
Virginia Beach city,518100460094,2019,81635,1548,97,93,4
Virginia Beach city,518100460094,2020,76731,1631,100,95,5
Virginia Beach city,518100460094,2021,84050,1517,64,63,1
Virginia Beach city,518100460101,2014,73571,986,0,0,0
Virginia Beach city,518100460101,2015,74219,901,0,0,0
Virginia Beach city,518100460101,2016,68125,833,6,6,0
Virginia Beach city,518100460101,2017,66389,831,7,7,0
Virginia Beach city,518100460101,2018,96500,835,7,7,0
Virginia Beach city,518100460101,2019,79875,784,18,18,0
Virginia Beach city,518100460101,2020,87386,596,17,17,0
Virginia Beach city,518100460101,2021,84821,804,42,42,0
Virginia Beach city,518100460102,2014,53375,1638,172,163,9
Virginia Beach city,518100460102,2015,53750,1627,160,148,12
Virginia Beach city,518100460102,2016,49338,1801,132,91,41
Virginia Beach city,518100460102,2017,63194,2068,82,57,25
Virginia Beach city,518100460102,2018,64469,2182,117,94,23
Virginia Beach city,518100460102,2019,64939,2153,80,36,44
Virginia Beach city,518100460102,2020,54551,2536,130,76,54
Virginia Beach city,518100460102,2021,65718,2282,100,84,16
Virginia Beach city,518100460111,2014,56250,1353,125,35,90
Virginia Beach city,518100460111,2015,59250,1243,110,32,78
Virginia Beach city,518100460111,2016,64318,1183,243,159,84
Virginia Beach city,518100460111,2017,66500,1090,256,152,104
Virginia Beach city,518100460111,2018,65583,1171,184,159,25
Virginia Beach city,518100460111,2019,68516,1146,243,180,63
Virginia Beach city,518100460111,2020,66842,1439,231,169,62
Virginia Beach city,518100460111,2021,70987,1514,116,60,56
Virginia Beach city,518100460121,2014,69250,3879,207,79,128
Virginia Beach city,518100460121,2015,63981,3225,177,74,103
Virginia Beach city,518100460121,2016,65224,2957,157,50,107
Virginia Beach city,518100460121,2017,61813,2958,176,61,115
Virginia Beach city,518100460121,2018,69610,2867,93,72,21
Virginia Beach city,518100460121,2019,74181,3235,98,78,20
Virginia Beach city,518100460122,2014,63060,1927,243,243,0
Virginia Beach city,518100460122,2015,55582,1925,294,294,0
Virginia Beach city,518100460122,2016,56083,2022,47,47,0
Virginia Beach city,518100460122,2017,58836,2318,30,30,0
Virginia Beach city,518100460122,2018,58207,2224,30,30,0
Virginia Beach city,518100460122,2019,62800,2160,0,0,0
Virginia Beach city,518100460123,2014,74712,1108,67,50,17
Virginia Beach city,518100460123,2015,75521,1067,107,84,23
Virginia Beach city,518100460123,2016,77788,935,119,99,20
Virginia Beach city,518100460123,2017,55833,860,38,16,22
Virginia Beach city,518100460123,2018,42632,868,21,0,21
Virginia Beach city,518100460123,2019,45813,708,0,0,0
Virginia Beach city,518100460124,2014,70682,545,6,6,0
Virginia Beach city,518100460124,2015,81287,886,28,28,0
Virginia Beach city,518100460124,2016,62008,854,27,27,0
Virginia Beach city,518100460124,2017,84071,745,16,16,0
Virginia Beach city,518100460124,2018,81250,772,24,24,0
Virginia Beach city,518100460124,2019,77120,784,41,21,20
Virginia Beach city,518100460131,2014,54141,1780,129,22,107
Virginia Beach city,518100460131,2015,57300,1918,110,29,81
Virginia Beach city,518100460131,2016,63189,1925,113,28,85
Virginia Beach city,518100460131,2017,67240,1991,160,29,131
Virginia Beach city,518100460131,2018,67738,1816,96,22,74
Virginia Beach city,518100460131,2019,76833,1852,152,13,139
Virginia Beach city,518100460131,2020,58043,1960,168,10,158
Virginia Beach city,518100460131,2021,59375,2145,151,44,107
Virginia Beach city,518100460132,2014,42692,1265,362,110,252
Virginia Beach city,518100460132,2015,41228,1209,415,127,288
Virginia Beach city,518100460132,2016,41064,1219,406,126,280
Virginia Beach city,518100460132,2017,42941,1401,267,21,246
Virginia Beach city,518100460132,2018,43214,1485,379,178,201
Virginia Beach city,518100460132,2019,52339,1440,260,157,103
Virginia Beach city,518100460132,2020,65417,1515,198,165,33
Virginia Beach city,518100460132,2021,57743,1450,356,335,21
Virginia Beach city,518100460133,2014,68333,838,135,48,87
Virginia Beach city,518100460133,2015,54896,636,118,38,80
Virginia Beach city,518100460133,2016,56667,601,155,42,113
Virginia Beach city,518100460133,2017,57143,531,79,32,47
Virginia Beach city,518100460133,2018,48333,481,72,11,61
Virginia Beach city,518100460133,2019,76250,571,141,70,71
Virginia Beach city,518100460133,2020,0,679,175,135,40
Virginia Beach city,518100460141,2014,56921,816,57,33,24
Virginia Beach city,518100460141,2015,52095,980,121,37,84
Virginia Beach city,518100460141,2016,65341,1059,115,43,72
Virginia Beach city,518100460141,2017,75833,1051,112,52,60
Virginia Beach city,518100460141,2018,54719,1079,163,57,106
Virginia Beach city,518100460141,2019,70000,1468,196,8,188
Virginia Beach city,518100460141,2020,92121,1992,149,0,149
Virginia Beach city,518100460141,2021,116523,2812,198,0,198
Virginia Beach city,518100460142,2014,74250,1144,27,27,0
Virginia Beach city,518100460142,2015,53750,660,14,14,0
Virginia Beach city,518100460142,2016,57353,570,13,13,0
Virginia Beach city,518100460142,2017,60500,542,36,11,25
Virginia Beach city,518100460142,2018,71875,700,82,55,27
Virginia Beach city,518100460142,2019,80000,632,188,132,56
Virginia Beach city,518100460142,2020,78300,1133,328,262,66
Virginia Beach city,518100460142,2021,81797,1363,315,247,68
Virginia Beach city,518100460143,2014,79189,2635,413,161,252
Virginia Beach city,518100460143,2015,77213,2554,242,108,134
Virginia Beach city,518100460143,2016,69464,2400,180,114,66
Virginia Beach city,518100460143,2017,76198,2340,125,74,51
Virginia Beach city,518100460143,2018,78514,2172,139,50,89
Virginia Beach city,518100460143,2019,89853,2084,127,23,104
Virginia Beach city,518100460143,2020,98125,1485,39,18,21
Virginia Beach city,518100460143,2021,117986,1371,24,15,9
Virginia Beach city,518100460151,2014,91528,938,29,20,9
Virginia Beach city,518100460151,2015,74231,1200,28,18,10
Virginia Beach city,518100460151,2016,79744,1196,42,26,16
Virginia Beach city,518100460151,2017,79423,1353,35,22,13
Virginia Beach city,518100460151,2018,88906,1831,14,8,6
Virginia Beach city,518100460151,2019,84557,1746,7,7,0
Virginia Beach city,518100460151,2020,103235,1686,5,5,0
Virginia Beach city,518100460151,2021,120286,1487,0,0,0
Virginia Beach city,518100460152,2014,60142,2095,7,7,0
Virginia Beach city,518100460152,2015,60444,2018,7,7,0
Virginia Beach city,518100460152,2016,69297,2018,7,7,0
Virginia Beach city,518100460152,2017,78490,1799,17,6,11
Virginia Beach city,518100460152,2018,91683,1691,69,52,17
Virginia Beach city,518100460152,2019,95804,1736,58,41,17
Virginia Beach city,518100460152,2020,97388,2183,77,59,18
Virginia Beach city,518100460152,2021,103229,2751,64,51,13
Virginia Beach city,518100460153,2014,69470,1239,124,78,46
Virginia Beach city,518100460153,2015,64979,1493,120,82,38
Virginia Beach city,518100460153,2016,69015,1195,287,229,58
Virginia Beach city,518100460153,2017,70896,1171,276,215,61
Virginia Beach city,518100460153,2018,70147,1073,326,304,22
Virginia Beach city,518100460153,2019,73000,1173,249,228,21
Virginia Beach city,518100460153,2020,108021,1911,201,178,23
Virginia Beach city,518100460153,2021,113625,1898,29,24,5
Virginia Beach city,518100460154,2014,80761,1003,96,32,64
Virginia Beach city,518100460154,2015,82011,861,63,15,48
Virginia Beach city,518100460154,2016,101125,587,88,53,35
Virginia Beach city,518100460154,2017,96094,635,72,50,22
Virginia Beach city,518100460154,2018,99167,658,52,31,21
Virginia Beach city,518100460154,2019,90938,734,43,24,19
Virginia Beach city,518100460154,2020,89630,649,38,29,9
Virginia Beach city,518100460154,2021,95875,697,17,8,9
Virginia Beach city,518100460161,2014,123688,3622,66,41,25
Virginia Beach city,518100460161,2015,117419,3652,57,0,57
Virginia Beach city,518100460161,2016,119931,3506,181,123,58
Virginia Beach city,518100460161,2017,121776,3665,184,137,47
Virginia Beach city,518100460161,2018,142153,3914,166,96,70
Virginia Beach city,518100460161,2019,142266,3788,181,118,63
Virginia Beach city,518100460161,2020,147961,3922,134,101,33
Virginia Beach city,518100460161,2021,154338,3974,54,18,36
Virginia Beach city,518100462041,2014,78656,2366,0,0,0
Virginia Beach city,518100462041,2015,78375,2373,17,17,0
Virginia Beach city,518100462041,2016,76679,2529,87,15,72
Virginia Beach city,518100462041,2017,75057,2547,255,123,132
Virginia Beach city,518100462041,2018,76474,2360,205,104,101
Virginia Beach city,518100462041,2019,78085,2309,221,100,121
Virginia Beach city,518100462041,2020,70407,2163,238,89,149
Virginia Beach city,518100462041,2021,70450,2143,249,84,165
Virginia Beach city,518100462042,2014,67019,2110,72,24,48
Virginia Beach city,518100462042,2015,62243,2266,51,29,22
Virginia Beach city,518100462042,2016,67065,2484,41,29,12
Virginia Beach city,518100462042,2017,67500,2524,77,66,11
Virginia Beach city,518100462042,2018,70556,2506,183,157,26
Virginia Beach city,518100462042,2019,74414,2557,194,168,26
Virginia Beach city,518100462042,2020,74797,2222,164,135,29
Virginia Beach city,518100462042,2021,94554,2264,187,162,25
Virginia Beach city,518100462061,2014,57061,481,52,0,52
Virginia Beach city,518100462061,2015,66579,622,49,0,49
Virginia Beach city,518100462061,2016,68393,660,26,0,26
Virginia Beach city,518100462061,2017,71458,634,22,0,22
Virginia Beach city,518100462061,2018,73804,480,14,14,0
Virginia Beach city,518100462061,2019,72609,529,13,13,0
Virginia Beach city,518100462061,2020,54205,451,13,13,0
Virginia Beach city,518100462061,2021,56993,465,25,25,0
Virginia Beach city,518100462062,2014,76324,2466,223,102,121
Virginia Beach city,518100462062,2015,78167,2426,214,84,130
Virginia Beach city,518100462062,2016,85612,2642,257,131,126
Virginia Beach city,518100462062,2017,87981,2584,153,88,65
Virginia Beach city,518100462062,2018,87434,2598,226,70,156
Virginia Beach city,518100462062,2019,97500,2462,164,48,116
Virginia Beach city,518100462062,2020,96420,2494,149,52,97
Virginia Beach city,518100462062,2021,103051,2065,123,1,122
Virginia Beach city,518100462063,2014,85240,1249,0,0,0
Virginia Beach city,518100462063,2015,76161,1312,0,0,0
Virginia Beach city,518100462063,2016,89185,1461,43,0,43
Virginia Beach city,518100462063,2017,89896,1502,46,0,46
Virginia Beach city,518100462063,2018,118977,1550,54,0,54
Virginia Beach city,518100462063,2019,103295,1493,96,13,83
Virginia Beach city,518100462063,2020,89191,1399,96,12,84
Virginia Beach city,518100462063,2021,90640,1120,83,17,66
Virginia Beach city,518100462064,2014,76023,830,73,50,23
Virginia Beach city,518100462064,2015,75625,748,49,29,20
Virginia Beach city,518100462064,2016,63125,618,54,40,14
Virginia Beach city,518100462064,2017,71339,764,33,17,16
Virginia Beach city,518100462064,2018,71310,741,47,27,20
Virginia Beach city,518100462064,2019,83810,684,14,14,0
Virginia Beach city,518100462064,2020,71250,929,27,27,0
Virginia Beach city,518100462064,2021,81417,1159,24,24,0
Virginia Beach city,518100462071,2014,72225,2583,123,48,75
Virginia Beach city,518100462071,2015,76357,2745,94,46,48
Virginia Beach city,518100462071,2016,76912,3327,85,48,37
Virginia Beach city,518100462071,2017,79643,3103,88,50,38
Virginia Beach city,518100462071,2018,90341,3288,51,19,32
Virginia Beach city,518100462071,2019,81912,3323,16,0,16
Virginia Beach city,518100462071,2020,94211,2800,0,0,0
Virginia Beach city,518100462071,2021,94964,2232,289,0,289
Virginia Beach city,518100462072,2014,62206,935,94,65,29
Virginia Beach city,518100462072,2015,85692,1278,74,50,24
Virginia Beach city,518100462072,2016,79688,1204,125,73,52
Virginia Beach city,518100462072,2017,88235,1121,120,70,50
Virginia Beach city,518100462072,2018,91161,1476,22,0,22
Virginia Beach city,518100462072,2019,91297,1541,30,12,18
Virginia Beach city,518100462072,2020,94500,1474,36,15,21
Virginia Beach city,518100462072,2021,98854,1446,97,97,0
Virginia Beach city,518100462073,2014,60789,1830,441,206,235
Virginia Beach city,518100462073,2015,59265,1713,302,226,76
Virginia Beach city,518100462073,2016,52225,1664,375,229,146
Virginia Beach city,518100462073,2017,44052,1805,539,414,125
Virginia Beach city,518100462073,2018,44077,1800,505,401,104
Virginia Beach city,518100462073,2019,44925,1668,462,360,102
Virginia Beach city,518100462073,2020,0,9,111,83,28
Virginia Beach city,518100462111,2014,71905,845,157,0,157
Virginia Beach city,518100462111,2015,90179,709,141,0,141
Virginia Beach city,518100462111,2016,94659,831,171,0,171
Virginia Beach city,518100462111,2017,100893,822,222,0,222
Virginia Beach city,518100462111,2018,107708,840,260,0,260
Virginia Beach city,518100462111,2019,111250,756,2,0,2
Virginia Beach city,518100462111,2020,153289,835,36,0,36
Virginia Beach city,518100462111,2021,123977,810,34,0,34
Virginia Beach city,518100462112,2014,89500,761,25,0,25
Virginia Beach city,518100462112,2015,89219,808,12,0,12
Virginia Beach city,518100462112,2016,92500,815,17,8,9
Virginia Beach city,518100462112,2017,97969,684,29,10,19
Virginia Beach city,518100462112,2018,91023,623,54,20,34
Virginia Beach city,518100462112,2019,72708,679,47,17,30
Virginia Beach city,518100462112,2020,75750,667,37,15,22
Virginia Beach city,518100462112,2021,79604,681,30,8,22
Virginia Beach city,518100462113,2014,81705,861,24,20,4
Virginia Beach city,518100462113,2015,88708,889,63,18,45
Virginia Beach city,518100462113,2016,81477,773,51,11,40
Virginia Beach city,518100462113,2017,81442,902,63,24,39
Virginia Beach city,518100462113,2018,100450,822,51,18,33
Virginia Beach city,518100462113,2019,105398,970,61,21,40
Virginia Beach city,518100462113,2020,105648,840,26,23,3
Virginia Beach city,518100462113,2021,111618,824,42,17,25
Virginia Beach city,518100462114,2014,65804,553,8,8,0
Virginia Beach city,518100462114,2015,69659,584,11,11,0
Virginia Beach city,518100462114,2016,61786,439,12,12,0
Virginia Beach city,518100462114,2017,0,418,7,7,0
Virginia Beach city,518100462114,2018,70964,496,10,6,4
Virginia Beach city,518100462114,2019,72167,477,9,6,3
Virginia Beach city,518100462114,2020,90972,590,6,3,3
Virginia Beach city,518100462114,2021,95833,713,23,2,21
Virginia Beach city,518100462121,2014,133468,1424,62,62,0
Virginia Beach city,518100462121,2015,133107,1570,65,65,0
Virginia Beach city,518100462121,2016,131146,1565,98,85,13
Virginia Beach city,518100462121,2017,118693,1501,78,18,60
Virginia Beach city,518100462121,2018,115197,1484,59,20,39
Virginia Beach city,518100462121,2019,118214,1670,50,0,50
Virginia Beach city,518100462121,2020,119702,1271,55,0,55
Virginia Beach city,518100462121,2021,133472,1190,54,0,54
Virginia Beach city,518100462122,2014,80417,1602,119,36,83
Virginia Beach city,518100462122,2015,84333,1435,68,35,33
Virginia Beach city,518100462122,2016,79605,1283,61,33,28
Virginia Beach city,518100462122,2017,87614,1342,70,8,62
Virginia Beach city,518100462122,2018,91741,1156,59,3,56
Virginia Beach city,518100462122,2019,90363,1303,39,0,39
Virginia Beach city,518100462122,2020,88029,1813,42,0,42
Virginia Beach city,518100462122,2021,94161,1680,25,0,25
Virginia Beach city,518100462123,2014,78553,845,8,8,0
Virginia Beach city,518100462123,2015,84531,821,53,8,45
Virginia Beach city,518100462123,2016,92813,888,96,49,47
Virginia Beach city,518100462123,2017,104722,839,98,53,45
Virginia Beach city,518100462123,2018,113625,938,97,59,38
Virginia Beach city,518100462123,2019,114583,740,93,59,34
Virginia Beach city,518100462123,2020,79500,681,50,50,0
Virginia Beach city,518100462123,2021,92273,750,27,10,17
Virginia Beach city,518100462131,2014,55521,2665,375,287,88
Virginia Beach city,518100462131,2015,65089,2298,401,316,85
Virginia Beach city,518100462131,2016,53102,2134,785,309,476
Virginia Beach city,518100462131,2017,52170,2053,639,256,383
Virginia Beach city,518100462131,2018,55788,1954,583,35,548
Virginia Beach city,518100462131,2019,58385,1880,523,30,493
Virginia Beach city,518100462131,2020,62193,2434,288,0,288
Virginia Beach city,518100462131,2021,64855,2275,55,0,55
Virginia Beach city,518100462132,2014,48158,632,100,0,100
Virginia Beach city,518100462132,2015,47750,656,102,0,102
Virginia Beach city,518100462132,2016,42115,648,28,0,28
Virginia Beach city,518100462132,2017,80303,494,7,0,7
Virginia Beach city,518100462132,2018,83548,684,0,0,0
Virginia Beach city,518100462132,2019,74583,618,0,0,0
Virginia Beach city,518100462132,2020,54205,757,0,0,0
Virginia Beach city,518100462132,2021,39815,823,0,0,0
Virginia Beach city,518100462133,2014,37813,1313,115,96,19
Virginia Beach city,518100462133,2015,34661,1519,241,101,140
Virginia Beach city,518100462133,2016,40440,1632,181,68,113
Virginia Beach city,518100462133,2017,37207,1628,197,66,131
Virginia Beach city,518100462133,2018,38908,1680,191,26,165
Virginia Beach city,518100462133,2019,42768,1816,273,32,241
Virginia Beach city,518100462133,2020,46197,1712,165,57,108
Virginia Beach city,518100462133,2021,49712,1981,157,78,79
Virginia Beach city,518100462134,2014,64091,993,33,32,1
Virginia Beach city,518100462134,2015,74492,1013,3,1,2
Virginia Beach city,518100462134,2016,80167,943,4,2,2
Virginia Beach city,518100462134,2017,67292,935,5,2,3
Virginia Beach city,518100462134,2018,73182,996,6,1,5
Virginia Beach city,518100462134,2019,63900,1005,23,1,22
Virginia Beach city,518100462134,2020,58155,1053,65,2,63
Virginia Beach city,518100462134,2021,64500,1006,58,1,57
Virginia Beach city,518100462141,2014,81042,1559,90,61,29
Virginia Beach city,518100462141,2015,77324,1712,163,147,16
Virginia Beach city,518100462141,2016,83182,1645,158,147,11
Virginia Beach city,518100462141,2017,79224,1743,163,146,17
Virginia Beach city,518100462141,2018,90972,1901,107,94,13
Virginia Beach city,518100462141,2019,97847,1778,328,88,240
Virginia Beach city,518100462141,2020,107174,1870,197,57,140
Virginia Beach city,518100462141,2021,104977,2063,185,40,145
Virginia Beach city,518100462142,2014,104514,770,14,10,4
Virginia Beach city,518100462142,2015,103929,859,17,12,5
Virginia Beach city,518100462142,2016,104500,826,5,0,5
Virginia Beach city,518100462142,2017,94702,749,15,10,5
Virginia Beach city,518100462142,2018,103000,889,17,13,4
Virginia Beach city,518100462142,2019,123333,698,23,20,3
Virginia Beach city,518100462142,2020,118636,768,12,9,3
Virginia Beach city,518100462142,2021,128894,757,9,7,2
Virginia Beach city,518100462143,2014,89667,1569,18,9,9
Virginia Beach city,518100462143,2015,90813,1386,20,8,12
Virginia Beach city,518100462143,2016,91563,1503,15,6,9
Virginia Beach city,518100462143,2017,96974,1468,87,19,68
Virginia Beach city,518100462143,2018,103929,1273,82,33,49
Virginia Beach city,518100462143,2019,109138,1301,77,26,51
Virginia Beach city,518100462143,2020,100625,1552,120,77,43
Virginia Beach city,518100462143,2021,109583,1362,78,43,35
Virginia Beach city,518100462144,2014,77917,1016,47,0,47
Virginia Beach city,518100462144,2015,73750,1126,55,0,55
Virginia Beach city,518100462144,2016,62277,1072,46,0,46
Virginia Beach city,518100462144,2017,63527,1186,67,23,44
Virginia Beach city,518100462144,2018,64566,1162,89,31,58
Virginia Beach city,518100462144,2019,71964,1116,91,68,23
Virginia Beach city,518100462144,2020,78450,1018,60,42,18
Virginia Beach city,518100462144,2021,83750,1033,70,48,22
Virginia Beach city,518100462161,2014,102781,2423,63,46,17
Virginia Beach city,518100462161,2015,98365,2491,46,29,17
Virginia Beach city,518100462161,2016,90536,2622,79,34,45
Virginia Beach city,518100462161,2017,98438,2555,36,36,0
Virginia Beach city,518100462161,2018,94762,2461,28,28,0
Virginia Beach city,518100462161,2019,89973,2425,0,0,0
Virginia Beach city,518100462161,2020,97006,2055,0,0,0
Virginia Beach city,518100462161,2021,94516,2070,0,0,0
Virginia Beach city,518100462162,2014,98750,1726,47,19,28
Virginia Beach city,518100462162,2015,94375,1543,44,14,30
Virginia Beach city,518100462162,2016,100583,1549,60,24,36
Virginia Beach city,518100462162,2017,103472,1508,17,7,10
Virginia Beach city,518100462162,2018,102411,1839,68,10,58
Virginia Beach city,518100462162,2019,106481,1605,40,8,32
Virginia Beach city,518100462162,2020,111146,1973,94,4,90
Virginia Beach city,518100462162,2021,114194,1973,38,0,38
Virginia Beach city,518100462163,2014,87500,1859,158,122,36
Virginia Beach city,518100462163,2015,87188,2015,260,141,119
Virginia Beach city,518100462163,2016,97375,1866,296,171,125
Virginia Beach city,518100462163,2017,99013,2069,175,29,146
Virginia Beach city,518100462163,2018,126429,1737,112,14,98
Virginia Beach city,518100462163,2019,133304,1920,85,14,71
Virginia Beach city,518100462163,2020,126250,2166,21,21,0
Virginia Beach city,518100462163,2021,129875,2091,18,18,0
Virginia Beach city,518100462171,2014,77528,1036,18,18,0
Virginia Beach city,518100462171,2015,81875,939,0,0,0
Virginia Beach city,518100462171,2016,90982,1118,0,0,0
Virginia Beach city,518100462171,2017,85556,1197,0,0,0
Virginia Beach city,518100462171,2018,88984,1227,0,0,0
Virginia Beach city,518100462171,2019,100764,1226,0,0,0
Virginia Beach city,518100462171,2020,104222,1154,0,0,0
Virginia Beach city,518100462171,2021,64406,1039,18,0,18
Virginia Beach city,518100462172,2014,98299,3836,250,147,103
Virginia Beach city,518100462172,2015,93709,3982,340,140,200
Virginia Beach city,518100462172,2016,91136,4041,284,106,178
Virginia Beach city,518100462172,2017,92431,3925,393,107,286
Virginia Beach city,518100462172,2018,110077,4018,380,117,263
Virginia Beach city,518100462172,2019,101800,4288,177,15,162
Virginia Beach city,518100462172,2020,109783,1924,54,51,3
Virginia Beach city,518100462172,2021,122706,2082,54,52,2
Virginia Beach city,518100462191,2014,80909,1574,0,0,0
Virginia Beach city,518100462191,2015,79420,1825,22,22,0
Virginia Beach city,518100462191,2016,71667,1667,21,21,0
Virginia Beach city,518100462191,2017,71813,1426,52,52,0
Virginia Beach city,518100462191,2018,61335,1382,73,73,0
Virginia Beach city,518100462191,2019,59679,1547,84,84,0
Virginia Beach city,518100462191,2020,54881,2004,55,55,0
Virginia Beach city,518100462191,2021,56896,2047,58,58,0
Virginia Beach city,518100462192,2014,92733,2398,109,37,72
Virginia Beach city,518100462192,2015,93581,2067,99,8,91
Virginia Beach city,518100462192,2016,92188,2008,155,69,86
Virginia Beach city,518100462192,2017,102898,2241,143,73,70
Virginia Beach city,518100462192,2018,105184,2183,123,75,48
Virginia Beach city,518100462192,2019,96389,1985,79,79,0
Virginia Beach city,518100462192,2020,78718,2687,79,79,0
Virginia Beach city,518100462192,2021,80684,2796,62,39,23
Virginia Beach city,518100462201,2014,44943,1678,405,60,345
Virginia Beach city,518100462201,2015,42188,2404,310,81,229
Virginia Beach city,518100462201,2016,39744,2316,355,61,294
Virginia Beach city,518100462201,2017,41723,2332,243,62,181
Virginia Beach city,518100462201,2018,46375,2171,151,38,113
Virginia Beach city,518100462201,2019,52877,2434,182,43,139
Virginia Beach city,518100462201,2020,53065,1991,188,46,142
Virginia Beach city,518100462201,2021,55589,2356,280,90,190
Virginia Beach city,518100462202,2014,44345,1678,201,74,127
Virginia Beach city,518100462202,2015,43321,1356,247,84,163
Virginia Beach city,518100462202,2016,38846,1102,197,71,126
Virginia Beach city,518100462202,2017,40956,1120,204,71,133
Virginia Beach city,518100462202,2018,58500,1505,200,116,84
Virginia Beach city,518100462202,2019,46823,1234,98,36,62
Virginia Beach city,518100462202,2020,49783,1520,103,62,41
Virginia Beach city,518100462202,2021,81328,1414,66,66,0
Virginia Beach city,518100462203,2014,61346,863,233,68,165
Virginia Beach city,518100462203,2015,58882,827,239,70,169
Virginia Beach city,518100462203,2016,59524,964,132,75,57
Virginia Beach city,518100462203,2017,50313,1067,184,104,80
Virginia Beach city,518100462203,2018,76164,1236,137,54,83
Virginia Beach city,518100462203,2019,87868,1222,110,20,90
Virginia Beach city,518100462203,2020,124767,1150,112,0,112
Virginia Beach city,518100462203,2021,116371,1023,88,0,88
Virginia Beach city,518100462211,2014,68056,983,54,18,36
Virginia Beach city,518100462211,2015,66806,785,0,0,0
Virginia Beach city,518100462211,2016,69500,791,0,0,0
Virginia Beach city,518100462211,2017,66429,663,104,104,0
Virginia Beach city,518100462211,2018,76389,588,90,90,0
Virginia Beach city,518100462211,2019,79844,706,96,96,0
Virginia Beach city,518100462211,2020,98438,811,140,140,0
Virginia Beach city,518100462211,2021,104178,795,154,154,0
Virginia Beach city,518100462212,2014,35766,1072,53,35,18
Virginia Beach city,518100462212,2015,51163,1195,108,0,108
Virginia Beach city,518100462212,2016,52353,1161,85,0,85
Virginia Beach city,518100462212,2017,59338,877,125,12,113
Virginia Beach city,518100462212,2018,66172,943,182,33,149
Virginia Beach city,518100462212,2019,73636,1034,155,31,124
Virginia Beach city,518100462212,2020,84205,1076,50,32,18
Virginia Beach city,518100462212,2021,84712,1104,155,64,91
Virginia Beach city,518100462213,2014,36601,1448,317,56,261
Virginia Beach city,518100462213,2015,42138,1831,269,39,230
Virginia Beach city,518100462213,2016,44708,1957,294,39,255
Virginia Beach city,518100462213,2017,43164,1762,500,265,235
Virginia Beach city,518100462213,2018,55700,2126,329,279,50
Virginia Beach city,518100462213,2019,53700,1766,358,299,59
Virginia Beach city,518100462213,2020,49929,1445,536,327,209
Virginia Beach city,518100462213,2021,51806,1275,565,331,234
Virginia Beach city,518100462221,2014,79028,1332,7,0,7
Virginia Beach city,518100462221,2015,79583,1468,10,0,10
Virginia Beach city,518100462221,2016,84000,1549,57,26,31
Virginia Beach city,518100462221,2017,81250,1647,68,38,30
Virginia Beach city,518100462221,2018,93750,1694,67,32,35
Virginia Beach city,518100462221,2019,100469,1560,86,52,34
Virginia Beach city,518100462221,2020,99063,1628,75,41,34
Virginia Beach city,518100462221,2021,108807,1229,37,28,9
Virginia Beach city,518100462222,2014,92824,1008,10,10,0
Virginia Beach city,518100462222,2015,93191,1048,9,9,0
Virginia Beach city,518100462222,2016,96964,770,8,8,0
Virginia Beach city,518100462222,2017,92188,757,9,9,0
Virginia Beach city,518100462222,2018,93980,894,0,0,0
Virginia Beach city,518100462222,2019,96447,702,0,0,0
Virginia Beach city,518100462222,2020,99261,589,0,0,0
Virginia Beach city,518100462222,2021,101066,556,35,0,35
Virginia Beach city,518100462223,2014,96518,791,44,0,44
Virginia Beach city,518100462223,2015,97143,759,9,0,9
Virginia Beach city,518100462223,2016,102045,602,20,12,8
Virginia Beach city,518100462223,2017,101083,659,21,12,9
Virginia Beach city,518100462223,2018,110156,552,20,20,0
Virginia Beach city,518100462223,2019,96250,1016,23,23,0
Virginia Beach city,518100462223,2020,95000,1088,26,18,8
Virginia Beach city,518100462223,2021,107031,1280,21,11,10
Virginia Beach city,518100462224,2014,64706,938,143,73,70
Virginia Beach city,518100462224,2015,68098,1215,134,53,81
Virginia Beach city,518100462224,2016,76528,1226,69,11,58
Virginia Beach city,518100462224,2017,76250,1219,54,11,43
Virginia Beach city,518100462224,2018,79688,1254,44,3,41
Virginia Beach city,518100462224,2019,97656,1162,111,75,36
Virginia Beach city,518100462224,2020,123438,1022,58,43,15
Virginia Beach city,518100462224,2021,131411,1145,74,60,14
Virginia Beach city,518100462225,2014,98466,604,55,55,0
Virginia Beach city,518100462225,2015,87017,565,64,64,0
Virginia Beach city,518100462225,2016,86892,433,47,47,0
Virginia Beach city,518100462225,2017,89129,437,62,62,0
Virginia Beach city,518100462225,2018,62014,445,58,58,0
Virginia Beach city,518100462225,2019,81544,558,0,0,0
Virginia Beach city,518100462225,2020,65000,531,0,0,0
Virginia Beach city,518100462225,2021,64583,531,0,0,0
Virginia Beach city,518100462231,2014,90769,1064,11,0,11
Virginia Beach city,518100462231,2015,77917,1153,9,0,9
Virginia Beach city,518100462231,2016,76000,1142,10,0,10
Virginia Beach city,518100462231,2017,81000,1121,16,0,16
Virginia Beach city,518100462231,2018,92794,1101,16,5,11
Virginia Beach city,518100462231,2019,87143,1078,21,5,16
Virginia Beach city,518100462231,2020,83405,1397,22,4,18
Virginia Beach city,518100462231,2021,84333,1303,39,5,34
Virginia Beach city,518100462232,2014,97750,708,6,0,6
Virginia Beach city,518100462232,2015,77375,708,7,0,7
Virginia Beach city,518100462232,2016,79674,732,0,0,0
Virginia Beach city,518100462232,2017,82045,806,7,0,7
Virginia Beach city,518100462232,2018,81131,799,15,0,15
Virginia Beach city,518100462232,2019,89375,858,11,3,8
Virginia Beach city,518100462232,2020,87708,1036,11,2,9
Virginia Beach city,518100462232,2021,88047,915,9,2,7
Virginia Beach city,518100462233,2014,87448,927,15,13,2
Virginia Beach city,518100462233,2015,114286,793,25,23,2
Virginia Beach city,518100462233,2016,114107,761,39,22,17
Virginia Beach city,518100462233,2017,117000,776,33,21,12
Virginia Beach city,518100462233,2018,117083,780,39,29,10
Virginia Beach city,518100462233,2019,112841,725,47,30,17
Virginia Beach city,518100462233,2020,105606,697,51,29,22
Virginia Beach city,518100462233,2021,111667,793,34,34,0
Virginia Beach city,518100462241,2014,65724,1162,44,0,44
Virginia Beach city,518100462241,2015,52266,1316,214,149,65
Virginia Beach city,518100462241,2016,62069,1345,171,128,43
Virginia Beach city,518100462241,2017,61938,1368,220,190,30
Virginia Beach city,518100462241,2018,71389,1516,170,148,22
Virginia Beach city,518100462241,2019,67917,1408,182,149,33
Virginia Beach city,518100462241,2020,80379,1901,115,105,10
Virginia Beach city,518100462241,2021,79986,1861,102,87,15
Virginia Beach city,518100462242,2014,71250,1642,95,16,79
Virginia Beach city,518100462242,2015,90453,1535,78,22,56
Virginia Beach city,518100462242,2016,82969,1445,103,45,58
Virginia Beach city,518100462242,2017,90595,1459,101,37,64
Virginia Beach city,518100462242,2018,97222,1274,106,33,73
Virginia Beach city,518100462242,2019,104625,1347,101,35,66
Virginia Beach city,518100462242,2020,116719,1372,90,27,63
Virginia Beach city,518100462242,2021,115363,1333,81,3,78
Virginia Beach city,518100462243,2014,70484,1521,174,26,148
Virginia Beach city,518100462243,2015,64856,1350,65,55,10
Virginia Beach city,518100462243,2016,72719,1548,78,69,9
Virginia Beach city,518100462243,2017,77017,1273,36,29,7
Virginia Beach city,518100462243,2018,83083,1411,48,37,11
Virginia Beach city,518100462243,2019,83333,1515,40,40,0
Virginia Beach city,518100462243,2020,83456,1542,8,8,0
Virginia Beach city,518100462243,2021,76651,1442,0,0,0
Virginia Beach city,518100462251,2014,98472,1435,60,20,40
Virginia Beach city,518100462251,2015,88125,1655,53,21,32
Virginia Beach city,518100462251,2016,89750,1559,62,24,38
Virginia Beach city,518100462251,2017,82000,1517,68,24,44
Virginia Beach city,518100462251,2018,99625,1440,53,19,34
Virginia Beach city,518100462251,2019,100129,1448,4,2,2
Virginia Beach city,518100462251,2020,81771,1741,3,0,3
Virginia Beach city,518100462251,2021,73673,1697,21,18,3
Virginia Beach city,518100462252,2014,85000,1356,35,23,12
Virginia Beach city,518100462252,2015,77228,1009,30,21,9
Virginia Beach city,518100462252,2016,87955,1071,89,81,8
Virginia Beach city,518100462252,2017,83472,1040,108,101,7
Virginia Beach city,518100462252,2018,76818,1227,128,128,0
Virginia Beach city,518100462252,2019,79190,1232,90,90,0
Virginia Beach city,518100462252,2020,78690,1247,117,117,0
Virginia Beach city,518100462252,2021,83277,1515,51,51,0
Virginia Beach city,518100462253,2014,86290,1339,134,35,99
Virginia Beach city,518100462253,2015,80313,1233,177,29,148
Virginia Beach city,518100462253,2016,73523,1272,168,23,145
Virginia Beach city,518100462253,2017,90500,1445,35,24,11
Virginia Beach city,518100462253,2018,93185,1328,7,7,0
Virginia Beach city,518100462253,2019,102875,1528,80,80,0
Virginia Beach city,518100462253,2020,110625,1928,123,123,0
Virginia Beach city,518100462253,2021,123649,1883,146,146,0
Virginia Beach city,518100464001,2014,78947,1690,56,37,19
Virginia Beach city,518100464001,2015,73194,1705,102,65,37
Virginia Beach city,518100464001,2016,74861,1477,97,35,62
Virginia Beach city,518100464001,2017,76912,1566,105,46,59
Virginia Beach city,518100464001,2018,80592,1495,96,44,52
Virginia Beach city,518100464001,2019,78802,1441,139,47,92
Virginia Beach city,518100464001,2020,83636,1882,316,240,76
Virginia Beach city,518100464001,2021,98098,2099,299,263,36
Virginia Beach city,518100464002,2014,88750,1016,30,22,8
Virginia Beach city,518100464002,2015,83849,1024,31,22,9
Virginia Beach city,518100464002,2016,90125,1039,0,0,0
Virginia Beach city,518100464002,2017,91595,995,0,0,0
Virginia Beach city,518100464002,2018,94088,1045,0,0,0
Virginia Beach city,518100464002,2019,91250,904,0,0,0
Virginia Beach city,518100464002,2020,89321,1053,45,0,45
Virginia Beach city,518100464002,2021,93085,1279,47,0,47
Virginia Beach city,518100464003,2014,73917,749,17,7,10
Virginia Beach city,518100464003,2015,70455,813,32,23,9
Virginia Beach city,518100464003,2016,74565,960,65,24,41
Virginia Beach city,518100464003,2017,76313,1011,72,25,47
Virginia Beach city,518100464003,2018,79612,1147,78,32,46
Virginia Beach city,518100464003,2019,84000,1160,75,38,37
Virginia Beach city,518100464003,2020,96964,1111,46,20,26
Virginia Beach city,518100464003,2021,89276,990,9,1,8
Virginia Beach city,518100464004,2014,75250,1374,127,70,57
Virginia Beach city,518100464004,2015,76181,1242,87,34,53
Virginia Beach city,518100464004,2016,75250,1226,78,13,65
Virginia Beach city,518100464004,2017,81375,1142,36,15,21
Virginia Beach city,518100464004,2018,75179,1037,37,19,18
Virginia Beach city,518100464004,2019,76490,1148,32,16,16
Virginia Beach city,518100464004,2020,70259,1043,30,16,14
Virginia Beach city,518100464004,2021,74750,782,191,167,24
Virginia Beach city,518109901000,2016,0,0,0,0,0
Virginia Beach city,518109901000,2017,0,0,0,0,0
Virginia Beach city,518109901000,2018,0,0,0,0,0
Virginia Beach city,518109901000,2019,0,0,0,0,0
Virginia Beach city,518109901000,2020,0,0,0,0,0
